Game Id;PlayerId;TeamId;Game Rating;SA;GA;SV;SV%;TOI;PIM
5200;388;6;0;0;0;0;.00nan;0;0
5200;732;6;77;33;3;30;.909;3600000;0
5200;734;22;64;41;6;35;.854;3600000;0
5200;1223;22;0;0;0;0;.00nan;0;0
5211;731;4;66;32;4;28;.875;3600000;0
5211;963;26;64;26;3;23;.885;3600000;0
5211;995;4;0;0;0;0;.00nan;0;0
5211;1129;26;0;0;0;0;.00nan;0;0
5287;383;19;100;48;2;46;.958;3900000;0
5287;745;15;80;32;2;30;.938;3900000;0
5287;890;15;0;0;0;0;.00nan;0;0
5287;911;19;0;0;0;0;.00nan;0;0
5508;220;21;0;0;0;0;.00nan;0;0
5508;967;25;75;38;4;34;.895;3680600;0
5508;1207;21;63;33;5;28;.848;3687150;0
5508;1234;25;0;0;0;0;.00nan;0;0
5217;108;1;86;32;2;30;.938;3600000;0
5217;951;8;0;0;0;0;.00nan;0;0
5217;1388;1;0;0;0;0;.00nan;0;0
5217;1665;8;63;41;6;35;.854;3600000;0
5188;408;29;55;34;5;29;.853;3546600;0
5188;978;7;23;9;4;5;.556;885700;0
5188;1230;7;95;25;0;25;1.000;2714300;0
5188;1231;29;0;0;0;0;.00nan;0;0
5185;127;16;0;0;0;0;.00nan;0;0
5185;188;27;93;29;1;28;.966;3600000;0
5185;206;27;0;0;0;0;.00nan;0;0
5185;983;16;72;30;3;27;.900;3510300;0
5182;72;0;87;36;3;33;.917;3600000;0
5182;354;11;65;44;6;38;.864;3145200;0
5182;674;11;53;3;0;3;1.000;454800;0
5182;2135;0;0;0;0;0;.00nan;0;0
5208;396;12;0;0;0;0;.00nan;0;0
5208;780;3;0;0;0;0;.00nan;0;0
5208;808;12;75;45;5;40;.889;3556550;0
5208;1238;3;94;45;4;41;.911;3600000;0
5183;6;31;54;31;5;26;.839;3600000;0
5183;106;17;0;0;0;0;.00nan;0;0
5183;668;31;0;0;0;0;.00nan;0;0
5183;695;17;90;34;2;32;.941;3600000;0
5184;385;10;14;5;4;1;.200;817550;0
5184;774;20;0;0;0;0;.00nan;0;0
5184;869;20;73;19;1;18;.947;3600000;0
5184;1001;10;48;18;3;15;.833;2782450;0
5240;396;12;0;0;0;0;.00nan;0;0
5240;774;20;73;38;4;34;.895;3600000;0
5240;808;12;72;29;3;26;.897;3600000;0
5240;869;20;0;0;0;0;.00nan;0;0
5237;72;0;96;20;0;20;1.000;3600000;0
5237;274;18;0;0;0;0;.00nan;0;0
5237;748;18;94;44;2;42;.955;3533500;0
5237;2135;0;0;0;0;0;.00nan;0;0
5212;108;1;0;0;0;0;.00nan;0;0
5212;220;21;48;5;1;4;.800;926700;0
5212;1207;21;34;27;6;21;.778;2673300;0
5212;1388;1;82;33;3;30;.909;3600000;0
5192;106;17;62;14;1;13;.929;1598400;0
5192;383;19;0;0;0;0;.00nan;0;0
5192;695;17;32;20;5;15;.750;2001600;0
5192;911;19;66;27;3;24;.889;3600000;0
5186;731;4;70;35;4;31;.886;3549900;0
5186;734;22;72;30;3;27;.900;3600000;0
5186;995;4;0;0;0;0;.00nan;0;0
5186;1223;22;0;0;0;0;.00nan;0;0
5187;6;31;68;29;3;26;.897;3900000;0
5187;188;27;83;35;3;32;.914;3900000;0
5187;206;27;0;0;0;0;.00nan;0;0
5187;668;31;0;0;0;0;.00nan;0;0
5193;801;9;18;24;7;17;.708;2001900;0
5193;978;7;0;0;0;0;.00nan;0;0
5193;999;9;70;11;0;11;1.000;1598100;0
5193;1230;7;96;17;0;17;1.000;3600000;0
5189;127;16;0;0;0;0;.00nan;0;0
5189;780;3;0;0;0;0;.00nan;0;0
5189;983;16;53;33;5;28;.848;3600000;0
5189;1238;3;79;21;1;20;.952;3600000;0
5610;354;11;0;0;0;0;.00nan;0;0
5610;385;10;79;34;3;31;.912;3569750;0
5610;674;11;86;31;2;29;.935;3600000;0
5610;1001;10;0;0;0;0;.00nan;0;0
5181;963;26;98;47;3;44;.936;3600000;0
5181;967;25;94;19;0;19;1.000;3600000;0
5181;1129;26;0;0;0;0;.00nan;0;0
5181;1234;25;0;0;0;0;.00nan;0;0
5224;801;9;0;0;0;0;.00nan;0;0
5224;951;8;98;41;1;40;.976;3600000;0
5224;999;9;100;36;0;36;1.000;3600000;0
5224;1665;8;0;0;0;0;.00nan;0;0
5228;408;29;75;39;4;35;.897;3538250;0
5228;745;15;0;0;0;0;.00nan;0;0
5228;890;15;86;31;2;29;.935;3600000;0
5228;1231;29;0;0;0;0;.00nan;0;0
5197;274;18;0;0;0;0;.00nan;0;0
5197;388;6;21;21;6;15;.714;3600000;0
5197;732;6;0;0;0;0;.00nan;0;0
5197;748;18;88;26;1;25;.962;3600000;0
6121;127;16;84;25;1;24;.960;3600000;0
6121;734;22;0;0;0;0;.00nan;0;0
6121;983;16;0;0;0;0;.00nan;0;0
6121;1223;22;32;30;7;23;.767;3600000;0
5199;72;0;58;31;5;26;.839;3600000;0
5199;188;27;81;29;2;27;.931;3600000;0
5199;206;27;0;0;0;0;.00nan;0;0
5199;2135;0;0;0;0;0;.00nan;0;0
5255;780;3;54;30;5;25;.833;3574100;0
5255;963;26;0;0;0;0;.00nan;0;0
5255;1129;26;64;26;3;23;.885;3600000;0
5255;1238;3;0;0;0;0;.00nan;0;0
5209;6;31;0;0;0;0;.00nan;0;0
5209;385;10;52;32;5;27;.844;3600000;0
5209;668;31;81;29;2;27;.931;3600000;0
5209;1001;10;0;0;0;0;.00nan;0;0
6125;106;17;0;0;0;0;.00nan;0;0
6125;108;1;0;0;0;0;.00nan;0;0
6125;695;17;70;28;3;25;.893;3567000;0
6125;1388;1;95;36;1;35;.972;3600000;0
5261;354;11;17;19;6;13;.684;1314100;0
5261;674;11;48;16;3;13;.813;2285900;0
5261;774;20;0;0;0;0;.00nan;0;0
5261;869;20;77;21;1;20;.952;3600000;0
5195;220;21;0;0;0;0;.00nan;0;0
5195;731;4;100;22;0;22;1.000;3600000;0
5195;995;4;0;0;0;0;.00nan;0;0
5195;1207;21;70;40;5;35;.875;3600000;0
5190;396;12;0;0;0;0;.00nan;0;0
5190;408;29;54;26;4;22;.846;3516800;0
5190;808;12;85;30;2;28;.933;3600000;0
5190;1231;29;0;0;0;0;.00nan;0;0
6142;383;19;79;32;3;29;.906;3600000;0
6142;911;19;0;0;0;0;.00nan;0;0
6142;967;25;53;27;4;23;.852;3565500;0
6142;1234;25;0;0;0;0;.00nan;0;0
5311;396;12;30;14;4;10;.714;1182900;0
5311;808;12;43;21;4;17;.810;2417100;0
5311;967;25;94;18;0;18;1.000;3600000;0
5311;1234;25;0;0;0;0;.00nan;0;0
5219;745;15;0;0;0;0;.00nan;0;0
5219;890;15;75;37;4;33;.892;3541100;0
5219;963;26;100;44;2;42;.955;3600000;0
5219;1129;26;0;0;0;0;.00nan;0;0
5222;108;1;0;0;0;0;.00nan;0;0
5222;127;16;0;0;0;0;.00nan;0;0
5222;983;16;81;32;3;29;.906;3600000;0
5222;1388;1;100;29;0;29;1.000;3600000;0
5227;780;3;0;0;0;0;.00nan;0;0
5227;951;8;77;40;4;36;.900;3593300;0
5227;1238;3;84;30;2;28;.933;3600000;0
5227;1665;8;0;0;0;0;.00nan;0;0
5207;72;0;0;0;0;0;.00nan;0;0
5207;385;10;53;3;0;3;1.000;297400;0
5207;1001;10;43;26;5;21;.808;3266150;0
5207;2135;0;78;31;3;28;.903;3600000;0
5247;383;19;59;24;3;21;.875;3439550;0
5247;774;20;66;14;1;13;.929;3600000;0
5247;869;20;0;0;0;0;.00nan;0;0
5247;911;19;30;8;3;5;.625;160450;0
5251;274;18;77;44;4;40;.909;3900000;0
5251;748;18;0;0;0;0;.00nan;0;0
5251;801;9;0;0;0;0;.00nan;0;0
5251;999;9;61;30;4;26;.867;3900000;0
5201;6;31;12;22;7;15;.682;2222200;0
5201;388;6;81;28;2;26;.929;3600000;0
5201;668;31;68;11;0;11;1.000;1377800;0
5201;732;6;0;0;0;0;.00nan;0;0
5206;106;17;0;0;0;0;.00nan;0;0
5206;695;17;77;20;1;19;.950;3600000;0
5206;978;7;44;34;6;28;.824;3293400;0
5206;1230;7;26;6;3;3;.500;306600;0
5202;388;6;57;31;5;26;.839;3529550;0
5202;408;29;71;32;4;28;.875;3600000;0
5202;732;6;0;0;0;0;.00nan;0;0
5202;1231;29;0;0;0;0;.00nan;0;0
5375;745;15;0;0;0;0;.00nan;0;0
5375;890;15;73;31;3;28;.903;3581000;0
5375;951;8;100;34;1;33;.971;3600000;0
5375;1665;8;0;0;0;0;.00nan;0;0
5314;108;1;0;0;0;0;.00nan;0;0
5314;274;18;0;0;0;0;.00nan;0;0
5314;748;18;57;28;4;24;.857;3600000;0
5314;1388;1;88;35;3;32;.914;3600000;0
5191;220;21;0;0;0;0;.00nan;0;0
5191;734;22;44;34;6;28;.824;2425600;0
5191;1207;21;63;23;3;20;.870;3600000;0
5191;1223;22;41;7;2;5;.714;1174400;0
5233;780;3;0;0;0;0;.00nan;0;0
5233;967;25;52;32;5;27;.844;3600000;0
5233;1234;25;0;0;0;0;.00nan;0;0
5233;1238;3;85;29;2;27;.931;3600000;0
5196;354;11;0;0;0;0;.00nan;0;0
5196;674;11;86;30;2;28;.933;3600000;0
5196;731;4;52;31;5;26;.839;2399050;0
5196;995;4;72;12;0;12;1.000;1200950;0
5198;106;17;0;0;0;0;.00nan;0;0
5198;188;27;88;31;2;29;.935;3613350;0
5198;206;27;0;0;0;0;.00nan;0;0
5198;695;17;90;27;1;26;.963;3613350;0
5321;963;26;0;0;0;0;.00nan;0;0
5321;978;7;0;0;0;0;.00nan;0;0
5321;1129;26;50;24;4;20;.833;3600000;0
5321;1230;7;91;27;1;26;.963;3600000;0
5253;383;19;97;36;1;35;.972;3600000;0
5253;801;9;0;0;0;0;.00nan;0;0
5253;911;19;0;0;0;0;.00nan;0;0
5253;999;9;46;23;4;19;.826;3600000;0
5214;6;31;63;31;4;27;.871;3574400;0
5214;127;16;0;0;0;0;.00nan;0;0
5214;668;31;0;0;0;0;.00nan;0;0
5214;983;16;72;22;2;20;.909;3600000;0
6072;396;12;0;0;0;0;.00nan;0;0
6072;774;20;0;0;0;0;.00nan;0;0
6072;808;12;80;37;4;33;.892;3580250;0
6072;869;20;66;15;1;14;.933;3600000;0
5236;127;16;52;20;3;17;.850;3753150;0
5236;745;15;94;47;4;43;.915;3753150;0
5236;890;15;0;0;0;0;.00nan;0;0
5236;983;16;0;0;0;0;.00nan;0;0
5381;396;12;48;36;6;30;.833;3600000;0
5381;808;12;0;0;0;0;.00nan;0;0
5381;951;8;0;0;0;0;.00nan;0;0
5381;1665;8;100;29;0;29;1.000;3600000;0
5250;774;20;25;32;8;24;.750;3600000;0
5250;869;20;0;0;0;0;.00nan;0;0
5250;967;25;81;29;2;27;.931;3600000;0
5250;1234;25;0;0;0;0;.00nan;0;0
5218;274;18;59;29;4;25;.862;3568400;0
5218;385;10;81;35;3;32;.914;3600000;0
5218;748;18;0;0;0;0;.00nan;0;0
5218;1001;10;0;0;0;0;.00nan;0;0
5215;72;0;64;39;6;33;.846;3746800;0
5215;734;22;62;35;5;30;.857;3725100;0
5215;1223;22;0;0;0;0;.00nan;0;0
5215;2135;0;0;0;0;0;.00nan;0;0
5834;801;9;68;22;2;20;.909;3600000;0
5834;978;7;85;36;3;33;.917;3593900;0
5834;999;9;0;0;0;0;.00nan;0;0
5834;1230;7;0;0;0;0;.00nan;0;0
5234;383;19;0;0;0;0;.00nan;0;0
5234;408;29;73;25;2;23;.920;3600000;0
5234;911;19;98;49;3;46;.939;3577500;0
5234;1231;29;0;0;0;0;.00nan;0;0
5303;108;1;0;0;0;0;.00nan;0;0
5303;354;11;100;40;1;39;.975;3600000;0
5303;674;11;0;0;0;0;.00nan;0;0
5303;1388;1;73;31;3;28;.903;3543300;0
5210;106;17;61;19;2;17;.895;2447950;0
5210;388;6;0;0;0;0;.00nan;0;0
5210;695;17;17;7;4;3;.429;1063050;0
5210;732;6;77;38;4;34;.895;3600000;0
6152;72;0;52;32;5;27;.844;3550100;0
6152;220;21;0;0;0;0;.00nan;0;0
6152;1207;21;70;34;4;30;.882;3600000;0
6152;2135;0;0;0;0;0;.00nan;0;0
6144;745;15;0;0;0;0;.00nan;0;0
6144;890;15;71;37;4;33;.892;3568600;0
6144;951;8;97;42;3;39;.929;3600000;0
6144;1665;8;0;0;0;0;.00nan;0;0
5203;188;27;73;31;3;28;.903;3600000;0
5203;206;27;0;0;0;0;.00nan;0;0
5203;731;4;77;40;4;36;.900;3600000;0
5203;995;4;0;0;0;0;.00nan;0;0
5194;220;21;0;0;0;0;.00nan;0;0
5194;734;22;0;0;0;0;.00nan;0;0
5194;1207;21;93;30;1;29;.967;3600000;0
5194;1223;22;75;39;4;35;.897;3600000;0
6116;780;3;0;0;0;0;.00nan;0;0
6116;978;7;0;0;0;0;.00nan;0;0
6116;1230;7;69;37;5;32;.865;3630600;0
6116;1238;3;59;28;4;24;.857;3630600;0
5275;388;6;81;22;1;21;.955;3600000;0
5275;408;29;41;31;6;25;.806;3600000;0
5275;732;6;0;0;0;0;.00nan;0;0
5275;1231;29;0;0;0;0;.00nan;0;0
5256;383;19;28;6;3;3;.500;449500;0
5256;911;19;46;29;5;24;.828;3066650;0
5256;963;26;43;29;6;23;.793;3600000;0
5256;1129;26;0;0;0;0;.00nan;0;0
5254;274;18;0;0;0;0;.00nan;0;0
5254;385;10;97;28;0;28;1.000;3900000;0
5254;748;18;100;39;0;39;1.000;3900000;0
5254;1001;10;0;0;0;0;.00nan;0;0
5239;72;0;81;39;3;36;.923;3900000;0
5239;354;11;0;0;0;0;.00nan;0;0
5239;674;11;95;44;3;41;.932;3900000;0
5239;2135;0;0;0;0;0;.00nan;0;0
5213;731;4;0;0;0;0;.00nan;0;0
5213;801;9;0;0;0;0;.00nan;0;0
5213;995;4;79;32;3;29;.906;3546650;0
5213;999;9;100;37;2;35;.946;3600000;0
5220;188;27;100;42;2;40;.952;3600000;0
5220;206;27;0;0;0;0;.00nan;0;0
5220;396;12;0;0;0;0;.00nan;0;0
5220;808;12;74;42;5;37;.881;3600000;0
5231;734;22;93;31;1;30;.968;3787000;0
5231;745;15;0;0;0;0;.00nan;0;0
5231;890;15;94;51;2;49;.961;3787000;0
5231;1223;22;0;0;0;0;.00nan;0;0
5221;385;10;61;30;4;26;.867;3600000;0
5221;801;9;97;32;1;31;.969;3600000;0
5221;999;9;0;0;0;0;.00nan;0;0
5221;1001;10;0;0;0;0;.00nan;0;0
5204;127;16;70;23;2;21;.913;3563600;0
5204;188;27;100;48;1;47;.979;3600000;0
5204;206;27;0;0;0;0;.00nan;0;0
5204;983;16;0;0;0;0;.00nan;0;0
5232;220;21;0;0;0;0;.00nan;0;0
5232;780;3;0;0;0;0;.00nan;0;0
5232;1207;21;93;31;1;30;.968;3600000;0
5232;1238;3;93;37;2;35;.946;3600000;0
5263;354;11;56;38;6;32;.842;3346000;0
5263;674;11;43;3;1;2;.667;254000;0
5263;774;20;0;0;0;0;.00nan;0;0
5263;869;20;96;30;1;29;.967;3600000;0
5296;383;19;72;33;4;29;.879;3600000;0
5296;911;19;0;0;0;0;.00nan;0;0
5296;967;25;54;32;5;27;.844;3557500;0
5296;1234;25;0;0;0;0;.00nan;0;0
5365;274;18;0;0;0;0;.00nan;0;0
5365;748;18;63;19;2;17;.895;3600000;0
5365;951;8;0;0;0;0;.00nan;0;0
5365;1665;8;61;35;5;30;.857;3600000;0
5344;72;0;62;8;0;8;1.000;1372000;0
5344;963;26;0;0;0;0;.00nan;0;0
5344;1129;26;95;43;3;40;.930;3600000;0
5344;2135;0;36;22;5;17;.773;2175350;0
5358;106;17;0;0;0;0;.00nan;0;0
5358;695;17;54;26;4;22;.846;3600000;0
5358;745;15;50;29;5;24;.828;3581700;0
5358;890;15;0;0;0;0;.00nan;0;0
5205;108;1;48;6;1;5;.833;999800;0
5205;731;4;100;39;1;38;.974;3600000;0
5205;995;4;0;0;0;0;.00nan;0;0
5205;1388;1;23;21;6;15;.714;2600200;0
6126;220;21;71;13;0;13;1.000;1266800;0
6126;978;7;0;0;0;0;.00nan;0;0
6126;1207;21;43;24;5;19;.792;2327450;0
6126;1230;7;90;45;4;41;.911;3600000;0
5238;396;12;0;0;0;0;.00nan;0;0
5238;408;29;83;30;2;28;.933;3632100;0
5238;808;12;79;40;3;37;.925;3644500;0
5238;1231;29;0;0;0;0;.00nan;0;0
5216;6;31;82;51;6;45;.882;3600000;0
5216;668;31;0;0;0;0;.00nan;0;0
5216;731;4;39;24;5;19;.792;3600000;0
5216;995;4;0;0;0;0;.00nan;0;0
5270;354;11;0;0;0;0;.00nan;0;0
5270;408;29;68;32;4;28;.875;3900000;0
5270;674;11;81;39;4;35;.897;3900000;0
5270;1231;29;0;0;0;0;.00nan;0;0
5380;274;18;22;29;8;21;.724;3600000;0
5380;745;15;53;20;3;17;.850;1700000;0
5380;748;18;0;0;0;0;.00nan;0;0
5380;890;15;34;28;6;22;.786;1900000;0
5242;127;16;0;0;0;0;.00nan;0;0
5242;734;22;69;38;5;33;.868;3829300;0
5242;983;16;49;21;4;17;.810;3829300;0
5242;1223;22;0;0;0;0;.00nan;0;0
5266;774;20;0;0;0;0;.00nan;0;0
5266;780;3;0;0;0;0;.00nan;0;0
5266;869;20;72;18;1;17;.944;3600000;0
5266;1238;3;41;32;6;26;.813;3600000;0
5226;108;1;0;0;0;0;.00nan;0;0
5226;388;6;0;0;0;0;.00nan;0;0
5226;732;6;72;40;5;35;.875;3600000;0
5226;1388;1;100;33;1;32;.970;3600000;0
5524;963;26;50;31;5;26;.839;3578950;0
5524;978;7;63;31;4;27;.871;3600000;0
5524;1129;26;0;0;0;0;.00nan;0;0
5524;1230;7;0;0;0;0;.00nan;0;0
5225;385;10;77;27;2;25;.926;3600000;0
5225;967;25;67;25;3;22;.880;3578750;0
5225;1001;10;0;0;0;0;.00nan;0;0
5225;1234;25;0;0;0;0;.00nan;0;0
5248;106;17;0;0;0;0;.00nan;0;0
5248;396;12;100;53;1;52;.981;3600000;0
5248;695;17;54;20;3;17;.850;3590550;0
5248;808;12;0;0;0;0;.00nan;0;0
5245;734;22;0;0;0;0;.00nan;0;0
5245;780;3;82;34;3;31;.912;3600000;0
5245;1223;22;81;39;4;35;.897;3579900;0
5245;1238;3;0;0;0;0;.00nan;0;0
5235;220;21;0;0;0;0;.00nan;0;0
5235;388;6;84;29;2;27;.931;3600000;0
5235;732;6;0;0;0;0;.00nan;0;0
5235;1207;21;54;32;5;27;.844;3600000;0
5246;127;16;78;24;2;22;.917;3600000;0
5246;951;8;89;48;4;44;.917;3529800;0
5246;983;16;0;0;0;0;.00nan;0;0
5246;1665;8;0;0;0;0;.00nan;0;0
5264;106;17;0;0;0;0;.00nan;0;0
5264;695;17;81;32;3;29;.906;3600000;0
5264;774;20;72;42;5;37;.881;3564700;0
5264;869;20;0;0;0;0;.00nan;0;0
6154;354;11;77;52;6;46;.885;3232600;0
6154;674;11;34;4;2;2;.500;367400;0
6154;801;9;0;0;0;0;.00nan;0;0
6154;999;9;64;26;3;23;.885;3600000;0
6145;274;18;0;0;0;0;.00nan;0;0
6145;396;12;35;34;7;27;.794;3337600;0
6145;748;18;50;24;4;20;.833;3600000;0
6145;808;12;50;1;0;1;1.000;262400;0
5812;385;10;98;35;1;34;.971;3600000;0
5812;963;26;29;29;7;22;.759;3600000;0
5812;1001;10;0;0;0;0;.00nan;0;0
5812;1129;26;0;0;0;0;.00nan;0;0
5297;188;27;77;32;3;29;.906;3600000;0
5297;206;27;0;0;0;0;.00nan;0;0
5297;951;8;0;0;0;0;.00nan;0;0
5297;1665;8;60;32;5;27;.844;3530250;0
5230;108;1;75;38;4;34;.895;3600000;0
5230;220;21;71;19;1;18;.947;1240350;0
5230;1207;21;56;26;4;22;.846;2329450;0
5230;1388;1;0;0;0;0;.00nan;0;0
5386;967;25;71;35;4;31;.886;3900000;0
5386;978;7;0;0;0;0;.00nan;0;0
5386;1230;7;74;40;4;36;.900;3900000;0
5386;1234;25;0;0;0;0;.00nan;0;0
5223;6;31;0;0;0;0;.00nan;0;0
5223;383;19;0;0;0;0;.00nan;0;0
5223;668;31;75;37;4;33;.892;3567100;0
5223;911;19;67;24;3;21;.875;3600000;0
5763;72;0;84;42;4;38;.905;3600000;0
5763;978;7;57;35;5;30;.857;3568700;0
5763;1230;7;0;0;0;0;.00nan;0;0
5763;2135;0;0;0;0;0;.00nan;0;0
5229;6;31;93;41;3;38;.927;3600000;0
5229;668;31;0;0;0;0;.00nan;0;0
5229;801;9;0;0;0;0;.00nan;0;0
5229;999;9;74;37;4;33;.892;3562200;0
5273;127;16;0;0;0;0;.00nan;0;0
5273;801;9;83;30;2;28;.933;3600000;0
5273;983;16;91;29;1;28;.966;3600000;0
5273;999;9;0;0;0;0;.00nan;0;0
5241;220;21;0;0;0;0;.00nan;0;0
5241;734;22;90;34;2;32;.941;3600000;0
5241;1207;21;57;35;5;30;.857;3591400;0
5241;1223;22;0;0;0;0;.00nan;0;0
5320;188;27;63;17;2;15;.882;3600000;0
5320;206;27;0;0;0;0;.00nan;0;0
5320;745;15;0;0;0;0;.00nan;0;0
5320;890;15;59;36;5;31;.861;3600000;0
6146;774;20;0;0;0;0;.00nan;0;0
6146;869;20;81;40;4;36;.900;3600000;0
6146;963;26;0;0;0;0;.00nan;0;0
6146;1129;26;86;25;1;24;.960;3600000;0
5403;106;17;0;0;0;0;.00nan;0;0
5403;274;18;39;1;1;0;.000;403000;0
5403;695;17;86;36;3;33;.917;3600000;0
5403;748;18;50;36;6;30;.833;3197000;0
5279;108;1;0;0;0;0;.00nan;0;0
5279;731;4;68;26;3;23;.885;3600000;0
5279;995;4;0;0;0;0;.00nan;0;0
5279;1388;1;95;50;4;46;.920;3540200;0
5276;396;12;0;0;0;0;.00nan;0;0
5276;408;29;68;29;3;26;.897;3581400;0
5276;808;12;96;37;2;35;.946;3600000;0
5276;1231;29;0;0;0;0;.00nan;0;0
5305;951;8;34;22;5;17;.773;2052550;0
5305;967;25;42;29;6;23;.793;3600000;0
5305;1234;25;0;0;0;0;.00nan;0;0
5305;1665;8;32;14;4;10;.714;1547450;0
5272;388;6;0;0;0;0;.00nan;0;0
5272;396;12;84;24;1;23;.958;3600000;0
5272;732;6;100;27;0;27;1.000;3600000;0
5272;808;12;0;0;0;0;.00nan;0;0
5359;72;0;61;42;6;36;.857;3600000;0
5359;188;27;75;26;2;24;.923;3600000;0
5359;206;27;0;0;0;0;.00nan;0;0
5359;2135;0;0;0;0;0;.00nan;0;0
5243;220;21;0;0;0;0;.00nan;0;0
5243;774;20;55;21;3;18;.857;3600000;0
5243;869;20;0;0;0;0;.00nan;0;0
5243;1207;21;91;47;4;43;.915;3600000;0
5257;108;1;0;0;0;0;.00nan;0;0
5257;127;16;70;39;5;34;.872;3707300;0
5257;983;16;0;0;0;0;.00nan;0;0
5257;1388;1;73;35;4;31;.886;3707300;0
5371;731;4;0;0;0;0;.00nan;0;0
5371;745;15;82;34;3;31;.912;3600000;0
5371;890;15;0;0;0;0;.00nan;0;0
5371;995;4;49;33;6;27;.818;3600000;0
5308;274;18;63;24;3;21;.875;3600000;0
5308;383;19;0;0;0;0;.00nan;0;0
5308;748;18;0;0;0;0;.00nan;0;0
5308;911;19;32;21;5;16;.762;3572750;0
5265;385;10;56;32;5;27;.844;3545400;0
5265;780;3;0;0;0;0;.00nan;0;0
5265;1001;10;0;0;0;0;.00nan;0;0
5265;1238;3;57;27;4;23;.852;3600000;0
5258;408;29;74;42;5;37;.881;3600000;0
5258;734;22;0;0;0;0;.00nan;0;0
5258;1223;22;92;33;2;31;.939;3600000;0
5258;1231;29;0;0;0;0;.00nan;0;0
5290;385;10;0;0;0;0;.00nan;0;0
5290;967;25;100;25;0;25;1.000;3600000;0
5290;1001;10;90;34;2;32;.941;3563200;0
5290;1234;25;0;0;0;0;.00nan;0;0
5268;354;11;43;9;2;7;.778;1203850;0
5268;674;11;23;22;6;16;.727;2396150;0
5268;780;3;74;24;2;22;.917;3600000;0
5268;1238;3;0;0;0;0;.00nan;0;0
5295;72;0;83;28;2;26;.929;3600000;0
5295;801;9;0;0;0;0;.00nan;0;0
5295;999;9;77;39;4;35;.897;3588850;0
5295;2135;0;0;0;0;0;.00nan;0;0
6108;734;22;55;33;5;28;.848;3555750;0
6108;745;15;0;0;0;0;.00nan;0;0
6108;890;15;73;35;4;31;.886;3600000;0
6108;1223;22;0;0;0;0;.00nan;0;0
6095;108;1;0;0;0;0;.00nan;0;0
6095;731;4;32;38;8;30;.789;3600000;0
6095;995;4;0;0;0;0;.00nan;0;0
6095;1388;1;94;18;0;18;1.000;3600000;0
6164;106;17;61;35;5;30;.857;3600000;0
6164;274;18;0;0;0;0;.00nan;0;0
6164;695;17;0;0;0;0;.00nan;0;0
6164;748;18;48;41;7;34;.829;3531600;0
5267;127;16;0;0;0;0;.00nan;0;0
5267;951;8;32;26;6;20;.769;2967250;0
5267;983;16;84;36;3;33;.917;3600000;0
5267;1665;8;46;5;1;4;.800;632750;0
5300;383;19;100;35;1;34;.971;3600000;0
5300;911;19;0;0;0;0;.00nan;0;0
5300;978;7;0;0;0;0;.00nan;0;0
5300;1230;7;59;28;4;24;.857;3546200;0
5244;6;31;0;0;0;0;.00nan;0;0
5244;668;31;100;40;1;39;.975;3600000;0
5244;774;20;0;0;0;0;.00nan;0;0
5244;869;20;50;25;4;21;.840;3600000;0
5304;188;27;0;0;0;0;.00nan;0;0
5304;206;27;52;30;5;25;.833;3600000;0
5304;963;26;0;0;0;0;.00nan;0;0
5304;1129;26;76;24;2;22;.917;3600000;0
5262;396;12;99;24;0;24;1.000;3062050;0
5262;408;29;0;0;0;0;.00nan;0;0
5262;808;12;36;9;3;6;.667;537950;0
5262;1231;29;37;29;6;23;.793;3600000;0
5252;6;31;52;37;6;31;.838;2536450;0
5252;668;31;50;13;2;11;.846;1016000;0
5252;967;25;0;0;0;0;.00nan;0;0
5252;1234;25;50;30;5;25;.833;3600000;0
5291;108;1;0;0;0;0;.00nan;0;0
5291;801;9;0;0;0;0;.00nan;0;0
5291;999;9;85;29;2;27;.931;3600000;0
5291;1388;1;64;33;4;29;.879;3562450;0
6160;106;17;0;0;0;0;.00nan;0;0
6160;396;12;0;0;0;0;.00nan;0;0
6160;695;17;67;25;3;22;.880;3600000;0
6160;808;12;92;47;4;43;.915;3569200;0
5479;731;4;0;0;0;0;.00nan;0;0
5479;963;26;100;38;1;37;.974;3600000;0
5479;995;4;46;22;4;18;.818;3600000;0
5479;1129;26;0;0;0;0;.00nan;0;0
5249;388;6;34;10;3;7;.700;560150;0
5249;732;6;62;26;3;23;.885;2993000;0
5249;774;20;48;22;4;18;.818;3600000;0
5249;869;20;0;0;0;0;.00nan;0;0
5260;354;11;63;29;4;25;.862;3600000;0
5260;674;11;0;0;0;0;.00nan;0;0
5260;734;22;59;6;0;6;1.000;1141850;0
5260;1223;22;30;26;6;20;.769;2419450;0
5399;274;18;0;0;0;0;.00nan;0;0
5399;745;15;0;0;0;0;.00nan;0;0
5399;748;18;86;37;3;34;.919;3600000;0
5399;890;15;85;46;4;42;.913;3567350;0
6114;127;16;88;39;3;36;.923;3600000;0
6114;801;9;0;0;0;0;.00nan;0;0
6114;983;16;0;0;0;0;.00nan;0;0
6114;999;9;68;34;4;30;.882;3584600;0
5269;780;3;0;0;0;0;.00nan;0;0
5269;978;7;0;0;0;0;.00nan;0;0
5269;1230;7;61;31;4;27;.871;3600000;0
5269;1238;3;100;31;0;31;1.000;3600000;0
5286;385;10;97;37;2;35;.946;3600000;0
5286;388;6;62;30;4;26;.867;3547950;0
5286;732;6;0;0;0;0;.00nan;0;0
5286;1001;10;0;0;0;0;.00nan;0;0
5289;354;11;0;0;0;0;.00nan;0;0
5289;383;19;0;0;0;0;.00nan;0;0
5289;674;11;57;34;5;29;.853;3600000;0
5289;911;19;88;33;2;31;.939;3600000;0
5436;72;0;45;27;5;22;.815;3568550;0
5436;951;8;0;0;0;0;.00nan;0;0
5436;1665;8;92;43;4;39;.907;3600000;0
5436;2135;0;0;0;0;0;.00nan;0;0
5348;963;26;0;0;0;0;.00nan;0;0
5348;978;7;100;34;1;33;.971;3600000;0
5348;1129;26;91;40;2;38;.950;3558600;0
5348;1230;7;0;0;0;0;.00nan;0;0
5274;6;31;58;39;6;33;.846;3807900;0
5274;220;21;75;42;5;37;.881;3807900;0
5274;668;31;0;0;0;0;.00nan;0;0
5274;1207;21;0;0;0;0;.00nan;0;0
5282;774;20;0;0;0;0;.00nan;0;0
5282;869;20;57;29;4;25;.862;3600000;0
5282;963;26;100;36;1;35;.972;3600000;0
5282;1129;26;0;0;0;0;.00nan;0;0
5280;127;16;0;0;0;0;.00nan;0;0
5280;383;19;0;0;0;0;.00nan;0;0
5280;911;19;60;34;5;29;.853;3900000;0
5280;983;16;46;28;5;23;.821;3900000;0
5294;106;17;74;24;2;22;.917;3600000;0
5294;408;29;0;0;0;0;.00nan;0;0
5294;695;17;0;0;0;0;.00nan;0;0
5294;1231;29;81;39;4;35;.897;3512000;0
5411;801;9;0;0;0;0;.00nan;0;0
5411;951;8;0;0;0;0;.00nan;0;0
5411;999;9;43;21;4;17;.810;3544100;0
5411;1665;8;97;43;2;41;.953;3600000;0
5302;354;11;0;0;0;0;.00nan;0;0
5302;674;11;66;38;5;33;.868;3540200;0
5302;731;4;66;33;4;29;.879;3600000;0
5302;995;4;0;0;0;0;.00nan;0;0
5278;220;21;28;7;3;4;.571;1200700;0
5278;396;12;0;0;0;0;.00nan;0;0
5278;808;12;81;33;3;30;.909;3600000;0
5278;1207;21;30;32;7;25;.781;2399300;0
5271;6;31;0;0;0;0;.00nan;0;0
5271;668;31;74;30;3;27;.900;3600000;0
5271;734;22;73;42;5;37;.881;3548100;0
5271;1223;22;0;0;0;0;.00nan;0;0
5293;108;1;0;0;0;0;.00nan;0;0
5293;388;6;53;15;2;13;.867;1448950;0
5293;732;6;44;29;6;23;.793;2151050;0
5293;1388;1;55;25;4;21;.840;3600000;0
5315;108;1;0;0;0;0;.00nan;0;0
5315;745;15;70;34;4;30;.882;3400850;0
5315;890;15;26;12;4;8;.667;199150;0
5315;1388;1;66;15;1;14;.933;3600000;0
5277;188;27;0;0;0;0;.00nan;0;0
5277;206;27;61;18;2;16;.889;3600000;0
5277;734;22;62;37;5;32;.865;3600000;0
5277;1223;22;0;0;0;0;.00nan;0;0
5678;731;4;0;0;0;0;.00nan;0;0
5678;978;7;0;0;0;0;.00nan;0;0
5678;995;4;89;39;3;36;.923;3622350;0
5678;1230;7;88;32;2;30;.938;3622350;0
5316;354;11;59;22;3;19;.864;3600000;0
5316;674;11;0;0;0;0;.00nan;0;0
5316;967;25;27;11;4;7;.636;954550;0
5316;1234;25;36;21;5;16;.762;2645450;0
5259;385;10;52;31;5;26;.839;3600000;0
5259;774;20;96;19;0;19;1.000;3600000;0
5259;869;20;0;0;0;0;.00nan;0;0
5259;1001;10;0;0;0;0;.00nan;0;0
5329;274;18;0;0;0;0;.00nan;0;0
5329;748;18;65;33;4;29;.879;3731800;0
5329;780;3;0;0;0;0;.00nan;0;0
5329;1238;3;56;32;5;27;.844;3731800;0
6151;106;17;0;0;0;0;.00nan;0;0
6151;695;17;88;32;2;30;.938;3600000;0
6151;801;9;96;40;3;37;.925;3542550;0
6151;999;9;0;0;0;0;.00nan;0;0
5285;72;0;85;36;3;33;.917;3600000;0
5285;408;29;0;0;0;0;.00nan;0;0
5285;1231;29;100;31;0;31;1.000;3600000;0
5285;2135;0;0;0;0;0;.00nan;0;0
5351;106;17;0;0;0;0;.00nan;0;0
5351;108;1;92;34;2;32;.941;3600000;0
5351;695;17;88;40;3;37;.925;3600000;0
5351;1388;1;0;0;0;0;.00nan;0;0
5328;385;10;95;35;2;33;.943;3600000;0
5328;780;3;0;0;0;0;.00nan;0;0
5328;1001;10;0;0;0;0;.00nan;0;0
5328;1238;3;57;22;3;19;.864;3540200;0
5312;127;16;82;30;2;28;.933;3577050;0
5312;978;7;0;0;0;0;.00nan;0;0
5312;983;16;0;0;0;0;.00nan;0;0
5312;1230;7;93;29;1;28;.966;3600000;0
5410;745;15;79;40;4;36;.900;3860700;0
5410;801;9;0;0;0;0;.00nan;0;0
5410;890;15;0;0;0;0;.00nan;0;0
5410;999;9;83;36;3;33;.917;3860700;0
5388;274;18;79;27;2;25;.926;3600000;0
5388;748;18;0;0;0;0;.00nan;0;0
5388;967;25;68;35;4;31;.886;3535900;0
5388;1234;25;0;0;0;0;.00nan;0;0
5283;188;27;50;25;4;21;.840;3600000;0
5283;206;27;0;0;0;0;.00nan;0;0
5283;396;12;0;0;0;0;.00nan;0;0
5283;808;12;100;45;0;45;1.000;3600000;0
5301;354;11;0;0;0;0;.00nan;0;0
5301;674;11;74;42;5;37;.881;3525000;0
5301;734;22;0;0;0;0;.00nan;0;0
5301;1223;22;72;29;3;26;.897;3600000;0
5284;388;6;44;32;6;26;.813;3323950;0
5284;732;6;52;2;0;2;1.000;276050;0
5284;774;20;94;33;2;31;.939;3600000;0
5284;869;20;0;0;0;0;.00nan;0;0
5288;383;19;62;32;4;28;.875;3568300;0
5288;408;29;0;0;0;0;.00nan;0;0
5288;911;19;0;0;0;0;.00nan;0;0
5288;1231;29;97;31;1;30;.968;3600000;0
5281;220;21;71;35;4;31;.886;3724750;0
5281;951;8;63;37;5;32;.865;3724750;0
5281;1207;21;0;0;0;0;.00nan;0;0
5281;1665;8;0;0;0;0;.00nan;0;0
5382;274;18;0;0;0;0;.00nan;0;0
5382;748;18;72;30;3;27;.900;3600000;0
5382;801;9;48;30;5;25;.833;3530150;0
5382;999;9;0;0;0;0;.00nan;0;0
5298;383;19;0;0;0;0;.00nan;0;0
5298;385;10;0;0;0;0;.00nan;0;0
5298;911;19;95;31;1;30;.968;3600000;0
5298;1001;10;61;24;3;21;.875;3579800;0
5324;388;6;0;0;0;0;.00nan;0;0
5324;732;6;72;28;3;25;.893;3600000;0
5324;967;25;49;22;4;18;.818;2736200;0
5324;1234;25;25;11;4;7;.636;863800;0
5490;106;17;64;33;5;28;.848;3664150;0
5490;695;17;0;0;0;0;.00nan;0;0
5490;963;26;59;40;6;34;.850;3664150;0
5490;1129;26;0;0;0;0;.00nan;0;0
5448;188;27;0;0;0;0;.00nan;0;0
5448;206;27;77;38;4;34;.895;3891150;0
5448;745;15;0;0;0;0;.00nan;0;0
5448;890;15;79;34;3;31;.912;3891150;0
6149;731;4;0;0;0;0;.00nan;0;0
6149;734;22;66;25;3;22;.880;3600000;0
6149;995;4;100;41;2;39;.951;3600000;0
6149;1223;22;0;0;0;0;.00nan;0;0
5356;6;31;98;20;0;20;1.000;3600000;0
5356;396;12;0;0;0;0;.00nan;0;0
5356;668;31;0;0;0;0;.00nan;0;0
5356;808;12;98;43;1;42;.977;3600000;0
5313;72;0;75;43;5;38;.884;3873800;0
5313;220;21;0;0;0;0;.00nan;0;0
5313;1207;21;68;39;6;33;.846;3873800;0
5313;2135;0;0;0;0;0;.00nan;0;0
5327;72;0;0;0;0;0;.00nan;0;0
5327;780;3;0;0;0;0;.00nan;0;0
5327;1238;3;96;28;1;27;.964;3600000;0
5327;2135;0;73;44;5;39;.886;3600000;0
5355;6;31;0;0;0;0;.00nan;0;0
5355;668;31;57;33;5;28;.848;3566050;0
5355;978;7;63;31;4;27;.871;3600000;0
5355;1230;7;0;0;0;0;.00nan;0;0
5339;127;16;0;0;0;0;.00nan;0;0
5339;951;8;46;29;5;24;.828;3600000;0
5339;983;16;81;29;2;27;.931;3600000;0
5339;1665;8;0;0;0;0;.00nan;0;0
6103;396;12;100;48;2;46;.958;3600000;0
6103;808;12;0;0;0;0;.00nan;0;0
6103;978;7;0;0;0;0;.00nan;0;0
6103;1230;7;61;29;4;25;.862;3539250;0
6135;731;4;74;30;3;27;.900;3828250;0
6135;951;8;0;0;0;0;.00nan;0;0
6135;995;4;0;0;0;0;.00nan;0;0
6135;1665;8;85;42;4;38;.905;3828250;0
6134;963;26;77;34;3;31;.912;3900000;0
6134;967;25;78;31;3;28;.903;3900000;0
6134;1129;26;0;0;0;0;.00nan;0;0
6134;1234;25;0;0;0;0;.00nan;0;0
6068;188;27;53;39;6;33;.846;3557600;0
6068;206;27;0;0;0;0;.00nan;0;0
6068;780;3;54;25;4;21;.840;3600000;0
6068;1238;3;0;0;0;0;.00nan;0;0
5554;108;1;0;0;0;0;.00nan;0;0
5554;274;18;0;0;0;0;.00nan;0;0
5554;748;18;90;34;2;32;.941;3600000;0
5554;1388;1;75;31;3;28;.903;3600000;0
5442;274;18;77;20;1;19;.950;3600000;0
5442;396;12;0;0;0;0;.00nan;0;0
5442;748;18;0;0;0;0;.00nan;0;0
5442;808;12;66;45;6;39;.867;3600000;0
5336;188;27;0;0;0;0;.00nan;0;0
5336;206;27;87;34;3;31;.912;3600000;0
5336;354;11;0;0;0;0;.00nan;0;0
5336;674;11;32;27;6;21;.778;3600000;0
6132;6;31;71;26;3;23;.885;3600000;0
6132;383;19;61;30;4;26;.867;3600000;0
6132;668;31;0;0;0;0;.00nan;0;0
6132;911;19;0;0;0;0;.00nan;0;0
5330;388;6;85;36;3;33;.917;3725700;0
5330;732;6;0;0;0;0;.00nan;0;0
5330;745;15;0;0;0;0;.00nan;0;0
5330;890;15;94;37;2;35;.946;3725700;0
5332;127;16;0;0;0;0;.00nan;0;0
5332;967;25;0;0;0;0;.00nan;0;0
5332;983;16;84;30;2;28;.933;3600000;0
5332;1234;25;56;26;4;22;.846;3510350;0
5292;388;6;0;0;0;0;.00nan;0;0
5292;732;6;89;43;4;39;.907;3836850;0
5292;774;20;0;0;0;0;.00nan;0;0
5292;869;20;80;33;3;30;.909;3836850;0
5379;108;1;0;0;0;0;.00nan;0;0
5379;801;9;0;0;0;0;.00nan;0;0
5379;999;9;41;37;7;30;.811;3600000;0
5379;1388;1;64;32;4;28;.875;3600000;0
5310;731;4;0;0;0;0;.00nan;0;0
5310;734;22;79;31;3;28;.903;3600000;0
5310;995;4;79;39;4;35;.897;3600000;0
5310;1223;22;0;0;0;0;.00nan;0;0
5338;354;11;34;22;5;17;.773;1866750;0
5338;674;11;68;11;0;11;1.000;1680950;0
5338;951;8;82;38;4;34;.895;3600000;0
5338;1665;8;0;0;0;0;.00nan;0;0
5333;127;16;39;24;5;19;.792;3600000;0
5333;385;10;35;23;5;18;.783;1626250;0
5333;983;16;0;0;0;0;.00nan;0;0
5333;1001;10;50;19;3;16;.842;1973750;0
5318;6;31;0;0;0;0;.00nan;0;0
5318;383;19;0;0;0;0;.00nan;0;0
5318;668;31;91;47;4;43;.915;3559750;0
5318;911;19;81;29;2;27;.931;3600000;0
6155;106;17;0;0;0;0;.00nan;0;0
6155;695;17;100;27;0;27;1.000;3600000;0
6155;745;15;93;37;2;35;.946;3600000;0
6155;890;15;0;0;0;0;.00nan;0;0
5372;780;3;0;0;0;0;.00nan;0;0
5372;978;7;80;42;4;38;.905;3600000;0
5372;1230;7;0;0;0;0;.00nan;0;0
5372;1238;3;85;23;1;22;.957;3600000;0
5306;220;21;74;24;2;22;.917;3600000;0
5306;408;29;68;29;3;26;.897;3076800;0
5306;1207;21;0;0;0;0;.00nan;0;0
5306;1231;29;26;6;3;3;.500;523200;0
6161;963;26;44;4;1;3;.750;865050;0
6161;967;25;84;24;1;23;.958;3600000;0
6161;1129;26;17;31;8;23;.742;2734950;0
6161;1234;25;0;0;0;0;.00nan;0;0
5322;106;17;0;0;0;0;.00nan;0;0
5322;695;17;72;30;3;27;.900;3568350;0
5322;774;20;93;43;2;41;.953;3600000;0
5322;869;20;0;0;0;0;.00nan;0;0
5323;385;10;77;33;3;30;.909;3595900;0
5323;801;9;0;0;0;0;.00nan;0;0
5323;999;9;81;22;1;21;.955;3600000;0
5323;1001;10;0;0;0;0;.00nan;0;0
5334;383;19;48;29;5;24;.828;3600000;0
5334;731;4;79;15;0;15;1.000;1725050;0
5334;911;19;0;0;0;0;.00nan;0;0
5334;995;4;25;23;6;17;.739;1874950;0
5414;108;1;0;0;0;0;.00nan;0;0
5414;745;15;0;0;0;0;.00nan;0;0
5414;890;15;75;42;5;37;.881;3600000;0
5414;1388;1;93;36;2;34;.944;3600000;0
5408;963;26;50;30;5;25;.833;3575200;0
5408;967;25;0;0;0;0;.00nan;0;0
5408;1129;26;0;0;0;0;.00nan;0;0
5408;1234;25;81;34;3;31;.912;3600000;0
5452;274;18;0;0;0;0;.00nan;0;0
5452;748;18;92;34;2;32;.941;3600000;0
5452;780;3;0;0;0;0;.00nan;0;0
5452;1238;3;66;33;4;29;.879;3555250;0
5349;72;0;95;29;1;28;.966;3600000;0
5349;220;21;0;0;0;0;.00nan;0;0
5349;1207;21;41;30;6;24;.800;3600000;0
5349;2135;0;0;0;0;0;.00nan;0;0
5412;6;31;97;43;3;40;.930;3900000;0
5412;668;31;0;0;0;0;.00nan;0;0
5412;978;7;0;0;0;0;.00nan;0;0
5412;1230;7;100;44;3;41;.932;3900000;0
5353;127;16;0;0;0;0;.00nan;0;0
5353;951;8;30;24;6;18;.750;3545100;0
5353;983;16;79;44;5;39;.886;3600000;0
5353;1665;8;0;0;0;0;.00nan;0;0
5307;408;29;43;14;3;11;.786;1313700;0
5307;734;22;52;24;4;20;.833;3600000;0
5307;1223;22;0;0;0;0;.00nan;0;0
5307;1231;29;47;27;5;22;.815;2286300;0
5424;127;16;70;27;3;24;.889;3600000;0
5424;188;27;59;34;5;29;.853;3552400;0
5424;206;27;0;0;0;0;.00nan;0;0
5424;983;16;0;0;0;0;.00nan;0;0
5370;220;21;91;29;1;28;.966;3600000;0
5370;745;15;25;23;6;17;.739;1890500;0
5370;890;15;25;17;5;12;.706;1709500;0
5370;1207;21;0;0;0;0;.00nan;0;0
5347;354;11;0;0;0;0;.00nan;0;0
5347;674;11;54;32;5;27;.844;3600000;0
5347;731;4;96;33;2;31;.939;3600000;0
5347;995;4;0;0;0;0;.00nan;0;0
6133;780;3;64;38;5;33;.868;3600000;0
6133;801;9;93;30;1;29;.967;3600000;0
6133;999;9;0;0;0;0;.00nan;0;0
6133;1238;3;0;0;0;0;.00nan;0;0
5341;385;10;39;13;3;10;.769;1629300;0
5341;388;6;0;0;0;0;.00nan;0;0
5341;732;6;92;18;0;18;1.000;3600000;0
5341;1001;10;23;21;6;15;.714;1970700;0
5299;734;22;0;0;0;0;.00nan;0;0
5299;774;20;0;0;0;0;.00nan;0;0
5299;869;20;81;35;3;32;.914;3600000;0
5299;1223;22;79;40;4;36;.900;3600000;0
5395;106;17;96;35;2;33;.943;3600000;0
5395;396;12;0;0;0;0;.00nan;0;0
5395;695;17;0;0;0;0;.00nan;0;0
5395;808;12;91;58;5;53;.914;3600000;0
5420;396;12;44;34;6;28;.824;3600000;0
5420;808;12;0;0;0;0;.00nan;0;0
5420;967;25;64;26;3;23;.885;3600000;0
5420;1234;25;0;0;0;0;.00nan;0;0
5535;72;0;75;44;5;39;.886;3645050;0
5535;108;1;0;0;0;0;.00nan;0;0
5535;1388;1;47;32;6;26;.813;3645050;0
5535;2135;0;0;0;0;0;.00nan;0;0
5317;408;29;61;6;0;6;1.000;828100;0
5317;963;26;0;0;0;0;.00nan;0;0
5317;1129;26;65;25;3;22;.880;3600000;0
5317;1231;29;46;34;6;28;.824;2771900;0
5441;106;17;0;0;0;0;.00nan;0;0
5441;695;17;68;15;1;14;.933;3600000;0
5441;780;3;52;8;1;7;.875;1468750;0
5441;1238;3;32;27;6;21;.778;2131250;0
5538;951;8;89;44;2;42;.955;3600000;0
5538;963;26;88;27;1;26;.963;3600000;0
5538;1129;26;0;0;0;0;.00nan;0;0
5538;1665;8;0;0;0;0;.00nan;0;0
6122;388;6;88;37;3;34;.919;3600000;0
6122;408;29;54;44;7;37;.841;3600000;0
6122;732;6;0;0;0;0;.00nan;0;0
6122;1231;29;0;0;0;0;.00nan;0;0
5392;274;18;0;0;0;0;.00nan;0;0
5392;748;18;100;23;0;23;1.000;3600000;0
5392;801;9;0;0;0;0;.00nan;0;0
5392;999;9;85;41;4;37;.902;3600000;0
5331;188;27;100;40;2;38;.950;3900000;0
5331;206;27;0;0;0;0;.00nan;0;0
5331;383;19;0;0;0;0;.00nan;0;0
5331;911;19;83;31;2;29;.935;3900000;0
5985;6;31;68;40;5;35;.875;3578550;0
5985;354;11;0;0;0;0;.00nan;0;0
5985;668;31;0;0;0;0;.00nan;0;0
5985;674;11;73;31;3;28;.903;3600000;0
5361;72;0;100;35;1;34;.971;3600000;0
5361;734;22;39;31;6;25;.806;3600000;0
5361;1223;22;0;0;0;0;.00nan;0;0
5361;2135;0;0;0;0;0;.00nan;0;0
5409;354;11;65;31;4;27;.871;3600000;0
5409;674;11;0;0;0;0;.00nan;0;0
5409;731;4;41;29;6;23;.793;3600000;0
5409;995;4;0;0;0;0;.00nan;0;0
5797;396;12;0;0;0;0;.00nan;0;0
5797;808;12;59;23;3;20;.870;3600000;0
5797;978;7;52;38;6;32;.842;3600000;0
5797;1230;7;0;0;0;0;.00nan;0;0
5325;106;17;100;29;0;29;1.000;3600000;0
5325;695;17;0;0;0;0;.00nan;0;0
5325;774;20;39;31;6;25;.806;3120850;0
5325;869;20;46;4;1;3;.750;479150;0
6157;127;16;0;0;0;0;.00nan;0;0
6157;745;15;0;0;0;0;.00nan;0;0
6157;890;15;91;31;2;29;.935;3900000;0
6157;983;16;81;27;2;25;.926;3900000;0
5350;188;27;0;0;0;0;.00nan;0;0
5350;206;27;85;29;2;27;.931;3600000;0
5350;385;10;61;36;5;31;.861;3600000;0
5350;1001;10;0;0;0;0;.00nan;0;0
5961;108;1;59;23;3;20;.870;3600000;0
5961;396;12;59;41;6;35;.854;3196550;0
5961;808;12;64;9;0;9;1.000;403450;0
5961;1388;1;0;0;0;0;.00nan;0;0
5537;745;15;64;34;5;29;.853;3600000;0
5537;890;15;0;0;0;0;.00nan;0;0
5537;951;8;62;50;7;43;.860;3585050;0
5537;1665;8;0;0;0;0;.00nan;0;0
5522;963;26;0;0;0;0;.00nan;0;0
5522;967;25;55;21;3;18;.857;3557450;0
5522;1129;26;83;22;1;21;.955;3600000;0
5522;1234;25;0;0;0;0;.00nan;0;0
5309;731;4;0;0;0;0;.00nan;0;0
5309;734;22;0;0;0;0;.00nan;0;0
5309;995;4;78;43;5;38;.884;3600000;0
5309;1223;22;79;27;2;25;.926;3600000;0
5369;127;16;77;32;3;29;.906;3542900;0
5369;801;9;0;0;0;0;.00nan;0;0
5369;983;16;0;0;0;0;.00nan;0;0
5369;999;9;94;35;2;33;.943;3600000;0
5387;6;31;61;42;6;36;.857;2997250;0
5387;388;6;55;9;1;8;.889;713400;0
5387;668;31;53;10;1;9;.900;902750;0
5387;732;6;69;43;6;37;.860;3186600;0
5337;383;19;90;27;1;26;.963;3600000;0
5337;780;3;0;0;0;0;.00nan;0;0
5337;911;19;0;0;0;0;.00nan;0;0
5337;1238;3;64;32;4;28;.875;3600000;0
5343;274;18;0;0;0;0;.00nan;0;0
5343;748;18;73;25;2;23;.920;3600000;0
5343;774;20;0;0;0;0;.00nan;0;0
5343;869;20;55;22;3;19;.864;3541200;0
5401;72;0;83;34;3;31;.912;3600000;0
5401;220;21;0;0;0;0;.00nan;0;0
5401;1207;21;45;27;5;22;.815;3544250;0
5401;2135;0;0;0;0;0;.00nan;0;0
6166;326;15;72;35;4;31;.886;3900000;0
6166;745;15;0;0;0;0;.00nan;0;0
6166;774;20;0;0;0;0;.00nan;0;0
6166;1693;20;90;47;4;43;.915;3900000;0
6168;220;21;0;0;0;0;.00nan;0;0
6168;801;9;0;0;0;0;.00nan;0;0
6168;999;9;54;31;5;26;.839;3600000;0
6168;1207;21;89;30;2;28;.933;3600000;0
6170;108;1;0;0;0;0;.00nan;0;0
6170;408;29;34;39;8;31;.795;3600000;0
6170;712;29;0;0;0;0;.00nan;0;0
6170;1388;1;100;27;0;27;1.000;3600000;0
6172;106;17;0;0;0;0;.00nan;0;0
6172;388;6;0;0;0;0;.00nan;0;0
6172;695;17;53;39;6;33;.846;3592150;0
6172;732;6;96;49;4;45;.918;3600000;0
6174;263;12;0;0;0;0;.00nan;0;0
6174;808;12;74;30;3;27;.900;3600000;0
6174;978;7;98;21;0;21;1.000;3600000;0
6174;1230;7;0;0;0;0;.00nan;0;0
6176;274;18;35;17;4;13;.765;3600000;0
6176;330;10;0;0;0;0;.00nan;0;0
6176;385;10;88;25;1;24;.960;3600000;0
6176;748;18;0;0;0;0;.00nan;0;0
6178;354;11;67;20;2;18;.900;3600000;0
6178;674;11;0;0;0;0;.00nan;0;0
6178;963;26;59;39;6;33;.846;3600000;0
6178;2031;26;0;0;0;0;.00nan;0;0
6180;383;19;16;6;4;2;.333;365700;0
6180;546;3;0;0;0;0;.00nan;0;0
6180;780;3;100;25;0;25;1.000;3600000;0
6180;2052;19;64;20;2;18;.900;3234300;0
6182;866;8;79;39;4;35;.897;3600000;0
6182;1234;25;0;0;0;0;.00nan;0;0
6182;1665;8;0;0;0;0;.00nan;0;0
6182;2026;25;52;31;5;26;.839;3545650;0
6184;6;31;68;34;4;30;.882;3600000;0
6184;188;27;97;43;3;40;.930;3600000;0
6184;475;31;0;0;0;0;.00nan;0;0
6184;911;27;0;0;0;0;.00nan;0;0
6186;731;4;88;39;3;36;.923;3587400;0
6186;983;16;0;0;0;0;.00nan;0;0
6186;1362;16;91;35;2;33;.943;3600000;0
6186;1687;4;0;0;0;0;.00nan;0;0
6188;72;0;97;39;3;36;.923;3551650;0
6188;734;22;88;32;2;30;.938;3600000;0
6188;1223;22;0;0;0;0;.00nan;0;0
6188;2142;0;0;0;0;0;.00nan;0;0
6190;108;1;0;0;0;0;.00nan;0;0
6190;963;26;41;37;7;30;.811;2780150;0
6190;1388;1;75;32;3;29;.906;3600000;0
6190;2031;26;43;3;1;2;.667;819850;0
6192;6;31;94;40;3;37;.925;3900000;0
6192;354;11;0;0;0;0;.00nan;0;0
6192;475;31;0;0;0;0;.00nan;0;0
6192;674;11;91;42;3;39;.929;3900000;0
6194;106;17;0;0;0;0;.00nan;0;0
6194;383;19;98;45;2;43;.956;3551950;0
6194;695;17;96;29;1;28;.966;3600000;0
6194;2052;19;0;0;0;0;.00nan;0;0
6196;978;7;90;28;1;27;.964;3600000;0
6196;1230;7;0;0;0;0;.00nan;0;0
6196;1234;25;64;38;5;33;.868;3600000;0
6196;2026;25;0;0;0;0;.00nan;0;0
6198;220;21;0;0;0;0;.00nan;0;0
6198;734;22;64;32;4;28;.875;3600000;0
6198;1207;21;92;18;0;18;1.000;3600000;0
6198;1223;22;0;0;0;0;.00nan;0;0
6200;731;4;100;41;1;40;.976;3600000;0
6200;866;8;0;0;0;0;.00nan;0;0
6200;1665;8;72;41;5;36;.878;3600000;0
6200;1687;4;0;0;0;0;.00nan;0;0
6202;72;0;76;47;6;41;.872;3692900;0
6202;546;3;0;0;0;0;.00nan;0;0
6202;780;3;46;19;4;15;.789;3644950;0
6202;2142;0;0;0;0;0;.00nan;0;0
6204;188;27;75;32;3;29;.906;3533200;0
6204;274;18;0;0;0;0;.00nan;0;0
6204;748;18;100;34;1;33;.971;3600000;0
6204;911;27;0;0;0;0;.00nan;0;0
6206;330;10;0;0;0;0;.00nan;0;0
6206;385;10;92;40;3;37;.925;3600000;0
6206;388;6;86;43;4;39;.907;3519900;0
6206;732;6;0;0;0;0;.00nan;0;0
6208;801;9;0;0;0;0;.00nan;0;0
6208;983;16;87;49;3;46;.939;3558750;0
6208;999;9;82;24;1;23;.958;3600000;0
6208;1362;16;0;0;0;0;.00nan;0;0
6210;326;15;0;0;0;0;.00nan;0;0
6210;408;29;100;39;2;37;.949;3600000;0
6210;712;29;0;0;0;0;.00nan;0;0
6210;745;15;39;31;6;25;.806;3600000;0
6212;263;12;94;29;1;28;.966;3258350;0
6212;774;20;0;0;0;0;.00nan;0;0
6212;808;12;34;10;3;7;.700;341650;0
6212;1693;20;76;30;3;27;.900;3600000;0
6214;330;10;79;33;3;30;.909;3600000;0
6214;385;10;0;0;0;0;.00nan;0;0
6214;801;9;0;0;0;0;.00nan;0;0
6214;999;9;73;38;4;34;.895;3600000;0
6216;72;0;0;0;0;0;.00nan;0;0
6216;546;3;57;41;6;35;.854;3584450;0
6216;780;3;0;0;0;0;.00nan;0;0
6216;2142;0;71;37;5;32;.865;3600000;0
6218;220;21;0;0;0;0;.00nan;0;0
6218;274;18;68;34;4;30;.882;3600000;0
6218;748;18;0;0;0;0;.00nan;0;0
6218;1207;21;100;38;1;37;.974;3600000;0
6220;6;31;14;5;4;1;.200;625850;0
6220;108;1;63;18;2;16;.889;3600000;0
6220;475;31;50;43;7;36;.837;2974150;0
6220;1388;1;0;0;0;0;.00nan;0;0
6222;106;17;62;28;4;24;.857;3560400;0
6222;695;17;0;0;0;0;.00nan;0;0
6222;734;22;0;0;0;0;.00nan;0;0
6222;1223;22;96;43;3;40;.930;3600000;0
6224;388;6;0;0;0;0;.00nan;0;0
6224;732;6;79;28;2;26;.929;3600000;0
6224;983;16;0;0;0;0;.00nan;0;0
6224;1362;16;73;44;5;39;.886;3600000;0
6226;383;19;0;0;0;0;.00nan;0;0
6226;408;29;0;0;0;0;.00nan;0;0
6226;712;29;66;33;4;29;.879;3701950;0
6226;2052;19;94;49;5;44;.898;3701950;0
6228;963;26;0;0;0;0;.00nan;0;0
6228;978;7;0;0;0;0;.00nan;0;0
6228;1230;7;61;30;4;26;.867;3600000;0
6228;2031;26;69;37;5;32;.865;3600000;0
6230;731;4;0;0;0;0;.00nan;0;0
6230;774;20;100;46;3;43;.935;3600000;0
6230;1687;4;57;28;4;24;.857;3591900;0
6230;1693;20;0;0;0;0;.00nan;0;0
6232;263;12;0;0;0;0;.00nan;0;0
6232;808;12;100;21;0;21;1.000;3600000;0
6232;866;8;25;10;4;6;.600;937800;0
6232;1665;8;66;22;2;20;.909;2662200;0
6234;188;27;0;0;0;0;.00nan;0;0
6234;326;15;74;28;3;25;.893;3600000;0
6234;745;15;0;0;0;0;.00nan;0;0
6234;911;27;67;42;6;36;.857;3600000;0
6236;354;11;69;38;5;33;.868;3620350;0
6236;674;11;0;0;0;0;.00nan;0;0
6236;1234;25;0;0;0;0;.00nan;0;0
6236;2026;25;95;44;4;40;.909;3620350;0
6238;326;15;52;7;1;6;.857;698050;0
6238;745;15;25;27;7;20;.741;2901950;0
6238;866;8;26;24;6;18;.750;2200800;0
6238;1665;8;41;13;3;10;.769;1344350;0
6240;108;1;0;0;0;0;.00nan;0;0
6240;731;4;88;45;4;41;.911;3570500;0
6240;1388;1;83;35;3;32;.914;3600000;0
6240;1687;4;0;0;0;0;.00nan;0;0
6242;106;17;0;0;0;0;.00nan;0;0
6242;188;27;91;45;4;41;.911;3629750;0
6242;695;17;81;34;3;31;.912;3629750;0
6242;911;27;0;0;0;0;.00nan;0;0
6244;6;31;92;40;2;38;.950;3900000;0
6244;274;18;0;0;0;0;.00nan;0;0
6244;475;31;0;0;0;0;.00nan;0;0
6244;748;18;100;35;2;33;.943;3900000;0
6246;354;11;23;22;6;16;.727;1791250;0
6246;388;6;0;0;0;0;.00nan;0;0
6246;674;11;64;14;1;13;.929;1808750;0
6246;732;6;81;29;2;27;.931;3600000;0
6248;546;3;0;0;0;0;.00nan;0;0
6248;780;3;50;18;3;15;.833;3600000;0
6248;963;26;12;22;7;15;.682;1580750;0
6248;2031;26;56;15;2;13;.867;2019250;0
6250;330;10;0;0;0;0;.00nan;0;0
6250;385;10;68;46;6;40;.870;3600000;0
6250;1234;25;70;29;3;26;.897;3600000;0
6250;2026;25;0;0;0;0;.00nan;0;0
6252;383;19;74;35;4;31;.886;3600000;0
6252;734;22;70;28;3;25;.893;3600000;0
6252;1223;22;0;0;0;0;.00nan;0;0
6252;2052;19;0;0;0;0;.00nan;0;0
6254;263;12;0;0;0;0;.00nan;0;0
6254;808;12;71;32;4;28;.875;3600000;0
6254;978;7;92;28;1;27;.964;3600000;0
6254;1230;7;0;0;0;0;.00nan;0;0
6256;220;21;44;10;2;8;.800;1442750;0
6256;774;20;84;30;2;28;.933;3600000;0
6256;1207;21;29;18;5;13;.722;2157250;0
6256;1693;20;0;0;0;0;.00nan;0;0
6258;72;0;17;19;6;13;.684;1881450;0
6258;983;16;0;0;0;0;.00nan;0;0
6258;1362;16;72;42;5;37;.881;3600000;0
6258;2142;0;44;16;3;13;.813;1718550;0
6260;408;29;86;38;3;35;.921;3600000;0
6260;712;29;0;0;0;0;.00nan;0;0
6260;801;9;0;0;0;0;.00nan;0;0
6260;999;9;54;25;4;21;.840;3579500;0
6262;383;19;0;0;0;0;.00nan;0;0
6262;388;6;66;33;4;29;.879;3600000;0
6262;732;6;0;0;0;0;.00nan;0;0
6262;2052;19;87;72;6;66;.917;3554950;0
6264;106;17;70;29;3;26;.897;3514300;0
6264;188;27;0;0;0;0;.00nan;0;0
6264;695;17;0;0;0;0;.00nan;0;0
6264;911;27;100;49;1;48;.980;3600000;0
6266;220;21;82;36;3;33;.917;3600000;0
6266;734;22;70;23;2;21;.913;3070350;0
6266;1207;21;0;0;0;0;.00nan;0;0
6266;1223;22;30;7;3;4;.571;454800;0
6268;963;26;67;42;5;37;.881;3307950;0
6268;978;7;0;0;0;0;.00nan;0;0
6268;1230;7;83;29;2;27;.931;3600000;0
6268;2031;26;62;8;0;8;1.000;292050;0
6270;326;15;52;37;6;31;.838;3219450;0
6270;745;15;57;5;0;5;1.000;380550;0
6270;1234;25;0;0;0;0;.00nan;0;0
6270;2026;25;70;22;2;20;.909;3600000;0
6272;354;11;0;0;0;0;.00nan;0;0
6272;546;3;100;33;0;33;1.000;3600000;0
6272;674;11;92;28;1;27;.964;3576700;0
6272;780;3;0;0;0;0;.00nan;0;0
6274;6;31;0;0;0;0;.00nan;0;0
6274;475;31;98;52;2;50;.962;3550700;0
6274;731;4;0;0;0;0;.00nan;0;0
6274;1687;4;91;29;1;28;.966;3600000;0
6276;330;10;78;33;4;29;.879;3792400;0
6276;385;10;0;0;0;0;.00nan;0;0
6276;801;9;0;0;0;0;.00nan;0;0
6276;999;9;57;35;5;30;.857;3792400;0
6278;274;18;84;29;2;27;.931;3600000;0
6278;748;18;0;0;0;0;.00nan;0;0
6278;983;16;59;24;3;21;.875;3560900;0
6278;1362;16;0;0;0;0;.00nan;0;0
6280;408;29;0;0;0;0;.00nan;0;0
6280;712;29;72;35;4;31;.886;3515950;0
6280;866;8;0;0;0;0;.00nan;0;0
6280;1665;8;100;39;1;38;.974;3600000;0
6282;72;0;68;29;3;26;.897;3600000;0
6282;774;20;0;0;0;0;.00nan;0;0
6282;1693;20;100;29;0;29;1.000;3600000;0
6282;2142;0;0;0;0;0;.00nan;0;0
6284;108;1;72;36;4;32;.889;3600000;0
6284;263;12;100;41;1;40;.976;3600000;0
6284;808;12;0;0;0;0;.00nan;0;0
6284;1388;1;0;0;0;0;.00nan;0;0
6286;388;6;0;0;0;0;.00nan;0;0
6286;732;6;77;31;3;28;.903;3600000;0
6286;734;22;46;28;5;23;.821;3515350;0
6286;1223;22;0;0;0;0;.00nan;0;0
6288;546;3;59;35;5;30;.857;3584850;0
6288;780;3;0;0;0;0;.00nan;0;0
6288;963;26;84;42;4;38;.905;3600000;0
6288;2031;26;0;0;0;0;.00nan;0;0
6290;263;12;0;0;0;0;.00nan;0;0
6290;808;12;88;27;1;26;.963;3600000;0
6290;983;16;0;0;0;0;.00nan;0;0
6290;1362;16;58;32;5;27;.844;3600000;0
6292;274;18;0;0;0;0;.00nan;0;0
6292;748;18;71;37;4;33;.892;3570250;0
6292;1234;25;86;37;3;34;.919;3600000;0
6292;2026;25;0;0;0;0;.00nan;0;0
6294;330;10;0;0;0;0;.00nan;0;0
6294;354;11;0;0;0;0;.00nan;0;0
6294;385;10;72;30;3;27;.900;3600000;0
6294;674;11;55;33;5;28;.848;3570300;0
6296;188;27;45;27;5;22;.815;3600000;0
6296;866;8;0;0;0;0;.00nan;0;0
6296;911;27;0;0;0;0;.00nan;0;0
6296;1665;8;100;54;4;50;.926;3600000;0
6298;6;31;48;36;6;30;.833;3129300;0
6298;72;0;81;34;3;31;.912;3600000;0
6298;475;31;57;4;0;4;1.000;470700;0
6298;2142;0;0;0;0;0;.00nan;0;0
6300;108;1;0;0;0;0;.00nan;0;0
6300;408;29;75;38;5;33;.868;3600000;0
6300;712;29;0;0;0;0;.00nan;0;0
6300;1388;1;57;41;6;35;.854;3576500;0
6302;326;15;0;0;0;0;.00nan;0;0
6302;745;15;68;28;3;25;.893;3600000;0
6302;801;9;0;0;0;0;.00nan;0;0
6302;999;9;58;39;6;33;.846;3555300;0
6304;383;19;89;35;2;33;.943;3592000;0
6304;978;7;86;25;1;24;.960;3600000;0
6304;1230;7;0;0;0;0;.00nan;0;0
6304;2052;19;0;0;0;0;.00nan;0;0
6306;220;21;0;0;0;0;.00nan;0;0
6306;774;20;0;0;0;0;.00nan;0;0
6306;1207;21;72;36;4;32;.889;3568350;0
6306;1693;20;85;29;2;27;.931;3600000;0
6308;106;17;0;0;0;0;.00nan;0;0
6308;695;17;57;28;4;24;.857;3600000;0
6308;731;4;94;46;4;42;.913;3552600;0
6308;1687;4;0;0;0;0;.00nan;0;0
6310;72;0;0;0;0;0;.00nan;0;0
6310;326;15;61;29;4;25;.862;3600000;0
6310;745;15;0;0;0;0;.00nan;0;0
6310;2142;0;45;33;6;27;.818;3511650;0
6312;188;27;0;0;0;0;.00nan;0;0
6312;330;10;63;31;4;27;.871;3600000;0
6312;385;10;0;0;0;0;.00nan;0;0
6312;911;27;79;34;3;31;.912;3600000;0
6314;108;1;100;35;0;35;1.000;3600000;0
6314;866;8;23;28;7;21;.750;2634700;0
6314;1388;1;0;0;0;0;.00nan;0;0
6314;1665;8;59;12;1;11;.917;965300;0
6316;801;9;0;0;0;0;.00nan;0;0
6316;978;7;0;0;0;0;.00nan;0;0
6316;999;9;86;25;1;24;.960;3600000;0
6316;1230;7;84;37;3;34;.919;3576650;0
6318;220;21;64;45;6;39;.867;3546900;0
6318;274;18;68;40;5;35;.875;3600000;0
6318;748;18;0;0;0;0;.00nan;0;0
6318;1207;21;0;0;0;0;.00nan;0;0
6320;734;22;0;0;0;0;.00nan;0;0
6320;1223;22;78;29;3;26;.897;3600000;0
6320;1234;25;0;0;0;0;.00nan;0;0
6320;2026;25;55;34;5;29;.853;3588100;0
6322;263;12;55;33;5;28;.848;3600000;0
6322;546;3;0;0;0;0;.00nan;0;0
6322;780;3;100;34;1;33;.971;3600000;0
6322;808;12;0;0;0;0;.00nan;0;0
6324;6;31;0;0;0;0;.00nan;0;0
6324;408;29;0;0;0;0;.00nan;0;0
6324;475;31;94;40;3;37;.925;3690350;0
6324;712;29;81;28;2;26;.929;3690350;0
6326;106;17;41;25;5;20;.800;3578500;0
6326;388;6;85;41;4;37;.902;3600000;0
6326;695;17;0;0;0;0;.00nan;0;0
6326;732;6;0;0;0;0;.00nan;0;0
6328;774;20;76;30;3;27;.900;3578850;0
6328;983;16;88;27;1;26;.963;3600000;0
6328;1362;16;0;0;0;0;.00nan;0;0
6328;1693;20;0;0;0;0;.00nan;0;0
6330;354;11;47;19;4;15;.789;3600000;0
6330;383;19;35;11;3;8;.727;1369250;0
6330;674;11;0;0;0;0;.00nan;0;0
6330;2052;19;38;28;6;22;.786;2230750;0
6332;731;4;0;0;0;0;.00nan;0;0
6332;963;26;79;17;0;17;1.000;1789100;0
6332;1687;4;55;21;3;18;.857;3600000;0
6332;2031;26;25;23;6;17;.739;1810900;0
1312;101;32;88;15;0;15;1.000;3600000;0
1312;890;51;85;38;3;35;.921;3600000;0
1312;2268;51;0;0;0;0;.00nan;0;0
1312;2427;32;0;0;0;0;.00nan;0;0
1313;206;62;77;27;2;25;.926;3600000;0
1313;668;40;76;33;3;30;.909;3573450;0
1313;2296;40;0;0;0;0;.00nan;0;0
1313;2374;62;0;0;0;0;.00nan;0;0
1314;230;44;23;10;4;6;.600;1011100;0
1314;664;41;72;29;3;26;.897;3600000;0
1314;673;41;0;0;0;0;.00nan;0;0
1314;2279;44;54;25;4;21;.840;2588900;0
1315;157;52;90;29;1;28;.966;3600000;0
1315;532;35;100;34;0;34;1.000;3600000;0
1315;703;52;0;0;0;0;.00nan;0;0
1315;2176;35;0;0;0;0;.00nan;0;0
1316;1189;34;82;30;2;28;.933;3600000;0
1316;1364;47;70;36;4;32;.889;3542100;0
1316;2247;47;0;0;0;0;.00nan;0;0
1316;2249;34;0;0;0;0;.00nan;0;0
1317;543;43;83;42;4;38;.905;3714850;0
1317;575;63;0;0;0;0;.00nan;0;0
1317;1534;63;68;38;5;33;.868;3714850;0
1317;2398;43;0;0;0;0;.00nan;0;0
1318;967;50;55;33;5;28;.848;3600000;0
1318;995;42;92;29;1;28;.966;3600000;0
1318;2179;42;0;0;0;0;.00nan;0;0
1318;2377;50;0;0;0;0;.00nan;0;0
1319;331;36;83;28;2;26;.929;3698250;0
1319;713;57;0;0;0;0;.00nan;0;0
1319;1748;57;73;29;3;26;.897;3698250;0
1319;2367;36;0;0;0;0;.00nan;0;0
1320;442;55;0;0;0;0;.00nan;0;0
1320;2076;55;89;33;2;31;.939;3600000;0
1320;2231;37;57;11;1;10;.909;1339300;0
1320;2360;37;28;25;6;19;.760;2260700;0
1321;532;35;71;29;3;26;.897;3600000;0
1321;890;51;71;36;4;32;.889;3570750;0
1321;2176;35;0;0;0;0;.00nan;0;0
1321;2268;51;0;0;0;0;.00nan;0;0
1322;206;62;85;37;3;34;.919;3538050;0
1322;668;40;81;23;1;22;.957;3600000;0
1322;2296;40;0;0;0;0;.00nan;0;0
1322;2374;62;0;0;0;0;.00nan;0;0
1323;102;59;74;39;5;34;.872;3600000;0
1323;1068;58;0;0;0;0;.00nan;0;0
1323;1333;58;90;33;2;31;.939;3600000;0
1323;2211;59;0;0;0;0;.00nan;0;0
1324;230;44;48;24;4;20;.833;3532950;0
1324;664;41;100;43;2;41;.953;3600000;0
1324;673;41;0;0;0;0;.00nan;0;0
1324;2279;44;0;0;0;0;.00nan;0;0
1325;396;45;0;0;0;0;.00nan;0;0
1325;869;56;71;38;5;33;.868;3547000;0
1325;2204;45;72;30;3;27;.900;3600000;0
1325;2232;56;0;0;0;0;.00nan;0;0
1326;101;32;62;24;3;21;.875;3895850;0
1326;157;52;76;33;3;30;.909;3900000;0
1326;703;52;0;0;0;0;.00nan;0;0
1326;2427;32;0;0;0;0;.00nan;0;0
1327;1058;48;94;30;1;29;.967;3600000;0
1327;1155;48;0;0;0;0;.00nan;0;0
1327;1189;34;30;38;8;30;.789;3160100;0
1327;2249;34;53;3;0;3;1.000;439900;0
1328;995;42;81;23;1;22;.957;3900000;0
1328;1238;38;100;31;1;30;.968;3900000;0
1328;2179;42;0;0;0;0;.00nan;0;0
1328;2443;38;0;0;0;0;.00nan;0;0
1329;1129;33;70;42;5;37;.881;3600000;0
1329;2157;33;0;0;0;0;.00nan;0;0
1329;2281;46;66;20;2;18;.900;3600000;0
1329;2426;46;0;0;0;0;.00nan;0;0
1330;268;54;0;0;0;0;.00nan;0;0
1330;1001;54;55;22;3;19;.864;3600000;0
1330;1364;47;0;0;0;0;.00nan;0;0
1330;2247;47;100;29;0;29;1.000;3600000;0
1331;494;53;0;0;0;0;.00nan;0;0
1331;501;49;0;0;0;0;.00nan;0;0
1331;951;53;98;40;2;38;.950;3582500;0
1331;1202;49;79;22;1;21;.955;3600000;0
1332;127;61;0;0;0;0;.00nan;0;0
1332;635;61;50;37;6;31;.838;3600000;0
1332;697;39;0;0;0;0;.00nan;0;0
1332;2248;39;100;39;0;39;1.000;3600000;0
1333;195;60;0;0;0;0;.00nan;0;0
1333;860;60;100;50;1;49;.980;3600000;0
1333;967;50;88;33;2;31;.939;3600000;0
1333;2377;50;0;0;0;0;.00nan;0;0
1334;268;54;0;0;0;0;.00nan;0;0
1334;442;55;62;29;4;25;.862;3787800;0
1334;1001;54;69;29;3;26;.897;3787800;0
1334;2076;55;0;0;0;0;.00nan;0;0
1335;102;59;81;27;2;25;.926;3600000;0
1335;1068;58;55;33;5;28;.848;3600000;0
1335;1333;58;0;0;0;0;.00nan;0;0
1335;2211;59;0;0;0;0;.00nan;0;0
1336;396;45;74;24;2;22;.917;3600000;0
1336;869;56;83;35;3;32;.914;3593700;0
1336;2204;45;0;0;0;0;.00nan;0;0
1336;2232;56;0;0;0;0;.00nan;0;0
1337;1129;33;91;44;3;41;.932;3558650;0
1337;2157;33;0;0;0;0;.00nan;0;0
1337;2281;46;81;29;2;27;.931;3600000;0
1337;2426;46;0;0;0;0;.00nan;0;0
1338;127;61;98;52;4;48;.923;3542400;0
1338;635;61;0;0;0;0;.00nan;0;0
1338;697;39;82;35;3;32;.914;3600000;0
1338;2248;39;0;0;0;0;.00nan;0;0
1339;1058;48;0;0;0;0;.00nan;0;0
1339;1155;48;69;41;5;36;.878;3600000;0
1339;2231;37;90;33;2;31;.939;3600000;0
1339;2360;37;0;0;0;0;.00nan;0;0
1340;331;36;88;33;2;31;.939;3600000;0
1340;713;57;0;0;0;0;.00nan;0;0
1340;1748;57;50;25;4;21;.840;3525300;0
1340;2367;36;0;0;0;0;.00nan;0;0
1341;127;61;53;33;5;28;.848;3600000;0
1341;635;61;0;0;0;0;.00nan;0;0
1341;1058;48;0;0;0;0;.00nan;0;0
1341;1155;48;100;27;0;27;1.000;3600000;0
1342;331;36;57;28;4;24;.857;3600000;0
1342;575;63;88;27;1;26;.963;3600000;0
1342;1534;63;0;0;0;0;.00nan;0;0
1342;2367;36;0;0;0;0;.00nan;0;0
1343;442;55;81;22;1;21;.955;3600000;0
1343;494;53;0;0;0;0;.00nan;0;0
1343;951;53;46;28;5;23;.821;3600000;0
1343;2076;55;0;0;0;0;.00nan;0;0
1344;102;59;75;31;3;28;.903;3575050;0
1344;532;35;99;39;2;37;.949;3600000;0
1344;2176;35;0;0;0;0;.00nan;0;0
1344;2211;59;0;0;0;0;.00nan;0;0
1345;575;63;84;28;2;26;.929;3900000;0
1345;1068;58;0;0;0;0;.00nan;0;0
1345;1333;58;100;33;2;31;.939;3900000;0
1345;1534;63;0;0;0;0;.00nan;0;0
1346;101;32;45;22;4;18;.818;1921500;0
1346;1364;47;0;0;0;0;.00nan;0;0
1346;2247;47;82;30;2;28;.933;3600000;0
1346;2427;32;62;13;1;12;.923;1678500;0
1347;967;50;0;0;0;0;.00nan;0;0
1347;1238;38;72;35;4;31;.886;3900000;0
1347;2377;50;69;39;4;35;.897;3900000;0
1347;2443;38;0;0;0;0;.00nan;0;0
1348;268;54;0;0;0;0;.00nan;0;0
1348;501;49;91;28;1;27;.964;3600000;0
1348;1001;54;93;37;2;35;.946;3589950;0
1348;1202;49;0;0;0;0;.00nan;0;0
1349;206;62;100;34;1;33;.971;3600000;0
1349;713;57;85;44;4;40;.909;3562500;0
1349;1748;57;0;0;0;0;.00nan;0;0
1349;2374;62;0;0;0;0;.00nan;0;0
1350;396;45;83;29;2;27;.931;3600000;0
1350;543;43;52;32;5;27;.844;3600000;0
1350;2204;45;0;0;0;0;.00nan;0;0
1350;2398;43;0;0;0;0;.00nan;0;0
1351;697;39;59;41;6;35;.854;2317650;0
1351;2231;37;81;21;1;20;.952;3600000;0
1351;2248;39;59;6;0;6;1.000;1282350;0
1351;2360;37;0;0;0;0;.00nan;0;0
1352;230;44;53;3;0;3;1.000;570100;0
1352;331;36;0;0;0;0;.00nan;0;0
1352;2279;44;20;24;7;17;.708;3029900;0
1352;2367;36;63;29;4;25;.862;3600000;0
1353;995;42;66;21;2;19;.905;3600000;0
1353;1129;33;0;0;0;0;.00nan;0;0
1353;2157;33;41;31;6;25;.806;3600000;0
1353;2179;42;0;0;0;0;.00nan;0;0
1354;442;55;79;28;2;26;.929;3731750;0
1354;494;53;92;39;3;36;.923;3731750;0
1354;951;53;0;0;0;0;.00nan;0;0
1354;2076;55;0;0;0;0;.00nan;0;0
1355;157;52;0;0;0;0;.00nan;0;0
1355;703;52;73;18;1;17;.944;3600000;0
1355;890;51;58;34;5;29;.853;3600000;0
1355;2268;51;0;0;0;0;.00nan;0;0
1356;664;41;62;32;4;28;.875;3600000;0
1356;668;40;76;20;1;19;.950;3600000;0
1356;673;41;0;0;0;0;.00nan;0;0
1356;2296;40;0;0;0;0;.00nan;0;0
1357;102;59;0;0;0;0;.00nan;0;0
1357;532;35;0;0;0;0;.00nan;0;0
1357;2176;35;62;37;5;32;.865;3600000;0
1357;2211;59;86;31;2;29;.935;3600000;0
1358;869;56;75;38;4;34;.895;3600000;0
1358;2232;56;0;0;0;0;.00nan;0;0
1358;2281;46;0;0;0;0;.00nan;0;0
1358;2426;46;49;17;3;14;.824;3600000;0
1359;543;43;0;0;0;0;.00nan;0;0
1359;1068;58;52;29;5;24;.828;3600000;0
1359;1333;58;0;0;0;0;.00nan;0;0
1359;2398;43;46;41;7;34;.829;3549350;0
1360;101;32;55;33;5;28;.848;3600000;0
1360;1364;47;88;33;2;31;.939;3600000;0
1360;2247;47;0;0;0;0;.00nan;0;0
1360;2427;32;0;0;0;0;.00nan;0;0
1361;268;54;72;23;2;21;.913;3600000;0
1361;1001;54;0;0;0;0;.00nan;0;0
1361;1189;34;0;0;0;0;.00nan;0;0
1361;2249;34;62;30;4;26;.867;3556800;0
1362;967;50;86;36;3;33;.917;3600000;0
1362;1238;38;53;3;0;3;1.000;394800;0
1362;2377;50;0;0;0;0;.00nan;0;0
1362;2443;38;50;35;6;29;.829;3205200;0
1363;206;62;0;0;0;0;.00nan;0;0
1363;713;57;78;27;2;25;.926;3600000;0
1363;1748;57;0;0;0;0;.00nan;0;0
1363;2374;62;65;39;5;34;.872;3600000;0
1364;697;39;100;37;1;36;.973;3600000;0
1364;2231;37;0;0;0;0;.00nan;0;0
1364;2248;39;0;0;0;0;.00nan;0;0
1364;2360;37;76;26;2;24;.923;3540850;0
1365;501;49;0;0;0;0;.00nan;0;0
1365;1058;48;0;0;0;0;.00nan;0;0
1365;1155;48;43;27;5;22;.815;3600000;0
1365;1202;49;78;27;2;25;.926;3600000;0
1366;230;44;75;20;1;19;.950;3600000;0
1366;331;36;17;7;4;3;.429;844200;0
1366;2279;44;0;0;0;0;.00nan;0;0
1366;2367;36;44;16;3;13;.813;2755800;0
1367;127;61;86;32;2;30;.938;3546550;0
1367;195;60;100;34;0;34;1.000;3600000;0
1367;635;61;0;0;0;0;.00nan;0;0
1367;860;60;0;0;0;0;.00nan;0;0
1368;995;42;0;0;0;0;.00nan;0;0
1368;1129;33;100;40;0;40;1.000;3600000;0
1368;2157;33;0;0;0;0;.00nan;0;0
1368;2179;42;52;20;3;17;.850;3600000;0
1369;102;59;79;21;1;20;.952;3600000;0
1369;890;51;0;0;0;0;.00nan;0;0
1369;2211;59;0;0;0;0;.00nan;0;0
1369;2268;51;91;17;0;17;1.000;3600000;0
1370;664;41;0;0;0;0;.00nan;0;0
1370;668;40;0;0;0;0;.00nan;0;0
1370;673;41;50;36;6;30;.833;3600000;0
1370;2296;40;100;28;0;28;1.000;3600000;0
1371;869;56;0;0;0;0;.00nan;0;0
1371;2232;56;77;39;4;35;.897;3552950;0
1371;2281;46;72;24;2;22;.917;3600000;0
1371;2426;46;0;0;0;0;.00nan;0;0
1372;101;32;0;0;0;0;.00nan;0;0
1372;157;52;79;34;3;31;.912;3600000;0
1372;703;52;0;0;0;0;.00nan;0;0
1372;2427;32;61;31;4;27;.871;3580000;0
1373;268;54;0;0;0;0;.00nan;0;0
1373;1001;54;85;38;2;36;.947;3900000;0
1373;1189;34;82;28;2;26;.929;3900000;0
1373;2249;34;0;0;0;0;.00nan;0;0
1374;501;49;61;24;3;21;.875;3600000;0
1374;1058;48;76;39;4;35;.897;3591950;0
1374;1155;48;0;0;0;0;.00nan;0;0
1374;1202;49;0;0;0;0;.00nan;0;0
1375;127;61;0;0;0;0;.00nan;0;0
1375;195;60;82;33;2;31;.939;3875500;0
1375;635;61;94;47;3;44;.936;3875500;0
1375;860;60;0;0;0;0;.00nan;0;0
1376;331;36;77;32;3;29;.906;3583600;0
1376;543;43;81;29;2;27;.931;3600000;0
1376;2367;36;0;0;0;0;.00nan;0;0
1376;2398;43;0;0;0;0;.00nan;0;0
1377;230;44;68;22;2;20;.909;3600000;0
1377;869;56;61;29;4;25;.862;3563200;0
1377;2232;56;0;0;0;0;.00nan;0;0
1377;2279;44;0;0;0;0;.00nan;0;0
1378;532;35;68;16;1;15;.938;3600000;0
1378;697;39;0;0;0;0;.00nan;0;0
1378;2176;35;0;0;0;0;.00nan;0;0
1378;2248;39;45;31;6;25;.806;3600000;0
1379;967;50;100;32;0;32;1.000;3600000;0
1379;2281;46;0;0;0;0;.00nan;0;0
1379;2377;50;0;0;0;0;.00nan;0;0
1379;2426;46;63;20;2;18;.900;3526850;0
1380;101;32;25;23;6;17;.739;2901600;0
1380;442;55;0;0;0;0;.00nan;0;0
1380;2076;55;80;28;2;26;.929;3600000;0
1380;2427;32;55;4;0;4;1.000;698400;0
1381;326;51;50;19;3;16;.842;2655900;0
1381;1364;47;75;19;1;18;.947;3600000;0
1381;2247;47;0;0;0;0;.00nan;0;0
1381;2268;51;17;7;4;3;.429;944100;0
1382;475;40;0;0;0;0;.00nan;0;0
1382;543;43;0;0;0;0;.00nan;0;0
1382;1729;43;74;38;4;34;.895;3600000;0
1382;2296;40;87;38;3;35;.921;3600000;0
1383;102;59;83;30;2;28;.933;3561250;0
1383;157;52;0;0;0;0;.00nan;0;0
1383;703;52;100;22;0;22;1.000;3600000;0
1383;2211;59;0;0;0;0;.00nan;0;0
1384;664;41;90;38;3;35;.921;3600000;0
1384;673;41;0;0;0;0;.00nan;0;0
1384;2281;46;84;31;2;29;.935;3600000;0
1384;2426;46;0;0;0;0;.00nan;0;0
1385;230;44;0;0;0;0;.00nan;0;0
1385;712;44;65;27;3;24;.889;3552200;0
1385;1693;56;0;0;0;0;.00nan;0;0
1385;2232;56;85;29;2;27;.931;3600000;0
1386;263;57;0;0;0;0;.00nan;0;0
1386;713;57;100;24;0;24;1.000;3600000;0
1386;1068;58;79;27;2;25;.926;3530350;0
1386;1333;58;0;0;0;0;.00nan;0;0
1387;235;61;61;35;4;31;.886;3900000;0
1387;635;61;0;0;0;0;.00nan;0;0
1387;1189;34;83;40;4;36;.900;3900000;0
1387;2249;34;0;0;0;0;.00nan;0;0
1388;268;54;0;0;0;0;.00nan;0;0
1388;330;54;89;33;2;31;.939;3573000;0
1388;1687;42;100;32;0;32;1.000;3600000;0
1388;2179;42;0;0;0;0;.00nan;0;0
1389;494;53;52;29;5;24;.828;3600000;0
1389;501;49;85;25;1;24;.960;3600000;0
1389;866;53;0;0;0;0;.00nan;0;0
1389;1202;49;0;0;0;0;.00nan;0;0
1390;331;36;0;0;0;0;.00nan;0;0
1390;2052;62;0;0;0;0;.00nan;0;0
1390;2367;36;97;18;0;18;1.000;3600000;0
1390;2374;62;46;29;5;24;.828;3600000;0
1391;575;63;93;41;3;38;.927;3600000;0
1391;1534;63;0;0;0;0;.00nan;0;0
1391;1747;45;0;0;0;0;.00nan;0;0
1391;2204;45;57;29;4;25;.862;3543350;0
1392;1058;48;21;9;4;5;.556;817350;0
1392;1155;48;59;24;3;21;.875;2782650;0
1392;2231;37;73;25;2;23;.920;3600000;0
1392;2360;37;0;0;0;0;.00nan;0;0
1393;195;60;100;24;0;24;1.000;3600000;0
1393;860;60;0;0;0;0;.00nan;0;0
1393;2026;50;0;0;0;0;.00nan;0;0
1393;2377;50;92;40;3;37;.925;3600000;0
1394;101;32;59;30;4;26;.867;2861350;0
1394;442;55;100;24;0;24;1.000;3600000;0
1394;2076;55;0;0;0;0;.00nan;0;0
1394;2427;32;25;11;4;7;.636;738650;0
1395;326;51;74;37;4;33;.892;3770200;0
1395;1364;47;0;0;0;0;.00nan;0;0
1395;2247;47;70;40;5;35;.875;3770200;0
1395;2268;51;0;0;0;0;.00nan;0;0
1396;475;40;63;19;2;17;.895;3600000;0
1396;543;43;39;42;8;34;.810;3296300;0
1396;1729;43;53;3;0;3;1.000;303700;0
1396;2296;40;0;0;0;0;.00nan;0;0
1397;102;59;0;0;0;0;.00nan;0;0
1397;157;52;97;39;2;37;.949;3600000;0
1397;703;52;0;0;0;0;.00nan;0;0
1397;2211;59;100;28;0;28;1.000;3600000;0
1398;664;41;0;0;0;0;.00nan;0;0
1398;673;41;56;33;5;28;.848;3600000;0
1398;2281;46;0;0;0;0;.00nan;0;0
1398;2426;46;100;25;0;25;1.000;3600000;0
1399;263;57;83;24;1;23;.958;3600000;0
1399;713;57;0;0;0;0;.00nan;0;0
1399;1068;58;41;8;2;6;.750;1611100;0
1399;1333;58;41;26;5;21;.808;1988900;0
1400;532;35;88;34;2;32;.941;3558450;0
1400;1461;39;82;24;1;23;.958;3600000;0
1400;2117;39;0;0;0;0;.00nan;0;0
1400;2176;35;0;0;0;0;.00nan;0;0
1401;546;38;81;44;5;39;.886;3517800;0
1401;1251;33;0;0;0;0;.00nan;0;0
1401;2031;33;63;24;3;21;.875;3600000;0
1401;2443;38;0;0;0;0;.00nan;0;0
1402;235;61;100;36;1;35;.972;3600000;0
1402;268;54;0;0;0;0;.00nan;0;0
1402;330;54;80;30;2;28;.933;3562950;0
1402;635;61;0;0;0;0;.00nan;0;0
1403;494;53;0;0;0;0;.00nan;0;0
1403;866;53;97;37;2;35;.946;3600000;0
1403;1687;42;83;23;1;22;.957;3600000;0
1403;2179;42;0;0;0;0;.00nan;0;0
1404;1058;48;44;28;5;23;.821;3600000;0
1404;1155;48;0;0;0;0;.00nan;0;0
1404;2231;37;0;0;0;0;.00nan;0;0
1404;2360;37;100;38;1;37;.974;3600000;0
1405;195;60;80;22;1;21;.955;3600000;0
1405;860;60;0;0;0;0;.00nan;0;0
1405;2026;50;55;34;5;29;.853;2399150;0
1405;2377;50;59;18;2;16;.889;1200850;0
1406;235;61;100;47;2;45;.957;3600000;0
1406;635;61;0;0;0;0;.00nan;0;0
1406;1189;34;35;21;4;17;.810;3519000;0
1406;2249;34;0;0;0;0;.00nan;0;0
1407;546;38;51;29;4;25;.862;3551000;0
1407;1251;33;80;28;2;26;.929;3600000;0
1407;2031;33;0;0;0;0;.00nan;0;0
1407;2443;38;0;0;0;0;.00nan;0;0
1408;268;54;0;0;0;0;.00nan;0;0
1408;330;54;99;40;2;38;.950;3600000;0
1408;501;49;61;32;4;28;.875;3600000;0
1408;1202;49;0;0;0;0;.00nan;0;0
1409;494;53;79;27;2;25;.926;3600000;0
1409;866;53;0;0;0;0;.00nan;0;0
1409;1687;42;0;0;0;0;.00nan;0;0
1409;2179;42;73;44;4;40;.909;3600000;0
1410;331;36;0;0;0;0;.00nan;0;0
1410;2052;62;79;35;2;33;.943;3582000;0
1410;2367;36;92;34;1;33;.971;3600000;0
1410;2374;62;0;0;0;0;.00nan;0;0
1411;230;44;0;0;0;0;.00nan;0;0
1411;712;44;44;14;3;11;.786;3812000;0
1411;1747;45;92;39;2;37;.949;3812000;0
1411;2204;45;0;0;0;0;.00nan;0;0
1412;263;57;66;22;2;20;.909;3900000;0
1412;475;40;62;21;2;19;.905;3893000;0
1412;713;57;0;0;0;0;.00nan;0;0
1412;2296;40;0;0;0;0;.00nan;0;0
1413;331;36;78;23;2;21;.913;3553000;0
1413;1068;58;0;0;0;0;.00nan;0;0
1413;1333;58;66;18;1;17;.944;3600000;0
1413;2367;36;0;0;0;0;.00nan;0;0
1414;195;60;79;27;2;25;.926;3600000;0
1414;860;60;0;0;0;0;.00nan;0;0
1414;2281;46;74;43;4;39;.907;3583000;0
1414;2426;46;0;0;0;0;.00nan;0;0
1415;442;55;67;34;4;30;.882;3582000;0
1415;1058;48;0;0;0;0;.00nan;0;0
1415;1155;48;72;35;3;32;.914;3600000;0
1415;2076;55;0;0;0;0;.00nan;0;0
1416;326;51;62;28;3;25;.893;3546000;0
1416;1364;47;56;17;2;15;.882;3600000;0
1416;2247;47;0;0;0;0;.00nan;0;0
1416;2268;51;0;0;0;0;.00nan;0;0
1417;263;57;45;32;6;26;.813;3599000;0
1417;475;40;57;26;4;22;.846;3600000;0
1417;713;57;0;0;0;0;.00nan;0;0
1417;2296;40;0;0;0;0;.00nan;0;0
1418;575;63;40;34;6;28;.824;3314000;0
1418;1534;63;48;0;0;0;.00nan;286000;0
1418;1693;56;47;21;3;18;.857;3600000;0
1418;2232;56;0;0;0;0;.00nan;0;0
1419;157;52;52;24;3;21;.875;3546000;0
1419;703;52;0;0;0;0;.00nan;0;0
1419;1189;34;67;22;2;20;.909;3600000;0
1419;2249;34;0;0;0;0;.00nan;0;0
1420;235;61;64;28;2;26;.929;3600000;0
1420;494;53;0;0;0;0;.00nan;0;0
1420;635;61;0;0;0;0;.00nan;0;0
1420;866;53;100;41;1;40;.976;3600000;0
1421;501;49;0;0;0;0;.00nan;0;0
1421;1202;49;72;34;4;30;.882;3600000;0
1421;1687;42;45;31;5;26;.839;3551000;0
1421;2179;42;0;0;0;0;.00nan;0;0
1422;331;36;57;10;1;9;.900;3900000;0
1422;1068;58;94;24;1;23;.958;3900000;0
1422;1333;58;0;0;0;0;.00nan;0;0
1422;2367;36;0;0;0;0;.00nan;0;0
1423;326;51;67;26;2;24;.923;3545000;0
1423;532;35;89;18;0;18;1.000;3600000;0
1423;2176;35;0;0;0;0;.00nan;0;0
1423;2268;51;0;0;0;0;.00nan;0;0
1424;664;41;65;41;5;36;.878;3600000;0
1424;673;41;0;0;0;0;.00nan;0;0
1424;2052;62;43;20;4;16;.800;3600000;0
1424;2374;62;0;0;0;0;.00nan;0;0
1425;101;32;71;32;3;29;.906;3600000;0
1425;501;49;100;32;0;32;1.000;3600000;0
1425;1202;49;0;0;0;0;.00nan;0;0
1425;2427;32;0;0;0;0;.00nan;0;0
1426;1189;34;54;21;3;18;.857;3600000;0
1426;1364;47;52;44;6;38;.864;3079000;0
1426;2247;47;49;2;0;2;1.000;521000;0
1426;2249;34;0;0;0;0;.00nan;0;0
1427;546;38;63;18;2;16;.889;3600000;0
1427;1687;42;27;8;3;5;.625;389000;0
1427;2179;42;57;27;3;24;.889;3211000;0
1427;2443;38;0;0;0;0;.00nan;0;0
1428;268;54;74;24;1;23;.958;3900000;0
1428;330;54;0;0;0;0;.00nan;0;0
1428;1058;48;0;0;0;0;.00nan;0;0
1428;1155;48;98;32;1;31;.969;3900000;0
1429;230;44;53;24;3;21;.875;3600000;0
1429;712;44;0;0;0;0;.00nan;0;0
1429;1747;45;22;34;7;27;.794;3600000;0
1429;2204;45;0;0;0;0;.00nan;0;0
1430;543;43;0;0;0;0;.00nan;0;0
1430;575;63;97;34;1;33;.971;3752000;0
1430;1534;63;0;0;0;0;.00nan;0;0
1430;1729;43;77;23;2;21;.913;3752000;0
1431;1251;33;0;0;0;0;.00nan;0;0
1431;2026;50;61;20;2;18;.900;3573000;0
1431;2031;33;72;24;1;23;.958;3600000;0
1431;2377;50;0;0;0;0;.00nan;0;0
1432;442;55;0;0;0;0;.00nan;0;0
1432;501;49;0;0;0;0;.00nan;0;0
1432;1202;49;61;39;5;34;.872;3575000;0
1432;2076;55;53;27;4;23;.852;3600000;0
1433;326;51;73;35;3;32;.914;3723000;0
1433;532;35;43;23;4;19;.826;3723000;0
1433;2176;35;0;0;0;0;.00nan;0;0
1433;2268;51;0;0;0;0;.00nan;0;0
1434;102;59;0;0;0;0;.00nan;0;0
1434;1461;39;47;30;5;25;.833;3634000;0
1434;2117;39;0;0;0;0;.00nan;0;0
1434;2211;59;72;40;4;36;.900;3634000;0
1435;664;41;0;0;0;0;.00nan;0;0
1435;673;41;89;34;2;32;.941;3521000;0
1435;2052;62;0;0;0;0;.00nan;0;0
1435;2374;62;88;17;0;17;1.000;3600000;0
1436;1693;56;62;22;3;19;.864;3545000;0
1436;2232;56;0;0;0;0;.00nan;0;0
1436;2281;46;73;29;2;27;.931;3600000;0
1436;2426;46;0;0;0;0;.00nan;0;0
1437;263;57;93;33;1;32;.970;3900000;0
1437;713;57;0;0;0;0;.00nan;0;0
1437;1068;58;0;0;0;0;.00nan;0;0
1437;1333;58;97;38;1;37;.974;3900000;0
1438;101;32;0;0;0;0;.00nan;0;0
1438;157;52;70;45;5;40;.889;3596000;0
1438;703;52;0;0;0;0;.00nan;0;0
1438;2427;32;54;26;3;23;.885;3600000;0
1439;1189;34;0;0;0;0;.00nan;0;0
1439;1364;47;0;0;0;0;.00nan;0;0
1439;2247;47;91;37;3;34;.919;3625000;0
1439;2249;34;66;20;2;18;.900;3625000;0
1440;195;60;51;17;2;15;.882;3600000;0
1440;546;38;0;0;0;0;.00nan;0;0
1440;860;60;0;0;0;0;.00nan;0;0
1440;2443;38;64;38;5;33;.868;3600000;0
1441;268;54;0;0;0;0;.00nan;0;0
1441;330;54;66;37;4;33;.892;3524000;0
1441;494;53;70;23;2;21;.913;3600000;0
1441;866;53;0;0;0;0;.00nan;0;0
1442;230;44;0;0;0;0;.00nan;0;0
1442;712;44;54;26;4;22;.846;3598000;0
1442;1747;45;70;34;3;31;.912;3600000;0
1442;2204;45;0;0;0;0;.00nan;0;0
1443;543;43;81;32;2;30;.938;3567000;0
1443;575;63;0;0;0;0;.00nan;0;0
1443;1534;63;94;28;1;27;.964;3600000;0
1443;1729;43;0;0;0;0;.00nan;0;0
1444;1251;33;78;38;3;35;.921;3599000;0
1444;2026;50;53;18;2;16;.889;3600000;0
1444;2031;33;0;0;0;0;.00nan;0;0
1444;2377;50;0;0;0;0;.00nan;0;0
1445;235;61;0;0;0;0;.00nan;0;0
1445;635;61;100;34;1;33;.971;3900000;0
1445;2231;37;0;0;0;0;.00nan;0;0
1445;2360;37;82;26;1;25;.962;3900000;0
1446;1693;56;48;36;5;31;.861;3521000;0
1446;2232;56;0;0;0;0;.00nan;0;0
1446;2281;46;0;0;0;0;.00nan;0;0
1446;2426;46;61;27;3;24;.889;3600000;0
1447;263;57;49;15;2;13;.867;3551000;0
1447;713;57;0;0;0;0;.00nan;0;0
1447;1068;58;100;22;0;22;1.000;3600000;0
1447;1333;58;0;0;0;0;.00nan;0;0
1448;1461;39;0;0;0;0;.00nan;0;0
1448;1687;42;0;0;0;0;.00nan;0;0
1448;2117;39;90;28;1;27;.964;3600000;0
1448;2179;42;74;32;3;29;.906;3578000;0
1449;235;61;76;33;3;30;.909;3582000;0
1449;635;61;0;0;0;0;.00nan;0;0
1449;2231;37;74;23;1;22;.957;3600000;0
1449;2360;37;0;0;0;0;.00nan;0;0
1450;575;63;50;41;6;35;.854;3600000;0
1450;1534;63;0;0;0;0;.00nan;0;0
1450;2052;62;0;0;0;0;.00nan;0;0
1450;2374;62;79;22;1;21;.955;3600000;0
1451;331;36;0;0;0;0;.00nan;0;0
1451;543;43;0;0;0;0;.00nan;0;0
1451;1729;43;99;28;1;27;.964;3600000;0
1451;2367;36;66;28;2;26;.929;3600000;0
1452;442;55;88;38;2;36;.947;3727000;0
1452;494;53;75;20;1;19;.950;3727000;0
1452;866;53;0;0;0;0;.00nan;0;0
1452;2076;55;0;0;0;0;.00nan;0;0
1453;101;32;0;0;0;0;.00nan;0;0
1453;501;49;100;35;2;33;.943;3900000;0
1453;657;32;81;27;2;25;.926;3900000;0
1453;1202;49;0;0;0;0;.00nan;0;0
1454;532;35;76;27;1;26;.963;3600000;0
1454;1461;39;52;32;5;27;.844;3600000;0
1454;2117;39;0;0;0;0;.00nan;0;0
1454;2176;35;0;0;0;0;.00nan;0;0
1455;268;54;0;0;0;0;.00nan;0;0
1455;330;54;100;34;0;34;1.000;3600000;0
1455;1058;48;0;0;0;0;.00nan;0;0
1455;1155;48;63;24;2;22;.917;3567000;0
1456;575;63;0;0;0;0;.00nan;0;0
1456;1534;63;82;39;3;36;.923;3519000;0
1456;2052;62;88;30;1;29;.967;3600000;0
1456;2374;62;0;0;0;0;.00nan;0;0
1457;193;45;92;37;2;35;.946;3900000;0
1457;263;57;0;0;0;0;.00nan;0;0
1457;713;57;67;20;2;18;.900;3900000;0
1457;1747;45;0;0;0;0;.00nan;0;0
1458;331;36;60;23;3;20;.870;3743000;0
1458;543;43;61;27;4;23;.852;3743000;0
1458;1729;43;0;0;0;0;.00nan;0;0
1458;2367;36;0;0;0;0;.00nan;0;0
1459;698;46;82;41;4;37;.902;3600000;0
1459;1687;42;84;30;1;29;.967;3600000;0
1459;2179;42;0;0;0;0;.00nan;0;0
1459;2426;46;0;0;0;0;.00nan;0;0
1460;442;55;37;31;5;26;.839;3600000;0
1460;494;53;0;0;0;0;.00nan;0;0
1460;866;53;73;25;2;23;.920;3600000;0
1460;2076;55;0;0;0;0;.00nan;0;0
1461;326;51;0;0;0;0;.00nan;0;0
1461;1082;51;74;36;3;33;.917;3600000;0
1461;1461;39;43;32;5;27;.844;3517000;0
1461;2117;39;0;0;0;0;.00nan;0;0
1462;501;49;39;23;4;19;.826;3526000;0
1462;532;35;77;25;2;23;.920;3600000;0
1462;1202;49;0;0;0;0;.00nan;0;0
1462;2176;35;0;0;0;0;.00nan;0;0
1463;1058;48;0;0;0;0;.00nan;0;0
1463;1155;48;77;30;2;28;.933;3547000;0
1463;1189;34;84;32;1;31;.969;3600000;0
1463;2249;34;0;0;0;0;.00nan;0;0
1464;546;38;19;23;6;17;.739;3600000;0
1464;1687;42;0;0;0;0;.00nan;0;0
1464;2179;42;100;40;0;40;1.000;3600000;0
1464;2443;38;0;0;0;0;.00nan;0;0
1465;193;45;80;27;2;25;.926;3600000;0
1465;575;63;0;0;0;0;.00nan;0;0
1465;1534;63;61;36;4;32;.889;3549000;0
1465;1747;45;0;0;0;0;.00nan;0;0
1466;157;52;0;0;0;0;.00nan;0;0
1466;703;52;63;16;2;14;.875;3600000;0
1466;830;47;67;29;3;26;.897;3549000;0
1466;2247;47;0;0;0;0;.00nan;0;0
1467;442;55;0;0;0;0;.00nan;0;0
1467;532;35;0;0;0;0;.00nan;0;0
1467;2076;55;73;39;4;35;.897;3584000;0
1467;2176;35;76;34;3;31;.912;3600000;0
1468;326;51;0;0;0;0;.00nan;0;0
1468;494;53;70;19;1;18;.947;3600000;0
1468;866;53;0;0;0;0;.00nan;0;0
1468;1082;51;61;28;3;25;.893;3574000;0
1469;475;40;53;27;3;24;.889;3900000;0
1469;1068;58;72;35;3;32;.914;3900000;0
1469;1333;58;0;0;0;0;.00nan;0;0
1469;2296;40;0;0;0;0;.00nan;0;0
1470;29;37;80;27;2;25;.926;3600000;0
1470;102;59;0;0;0;0;.00nan;0;0
1470;2211;59;59;34;5;29;.853;3600000;0
1470;2360;37;0;0;0;0;.00nan;0;0
1471;664;41;76;28;2;26;.929;3600000;0
1471;673;41;0;0;0;0;.00nan;0;0
1471;1251;33;0;0;0;0;.00nan;0;0
1471;2031;33;27;25;6;19;.760;3600000;0
1472;1693;56;93;41;3;38;.927;3900000;0
1472;2052;62;80;37;3;34;.919;3900000;0
1472;2232;56;0;0;0;0;.00nan;0;0
1472;2374;62;0;0;0;0;.00nan;0;0
1473;101;32;0;0;0;0;.00nan;0;0
1473;657;32;76;42;4;38;.905;3600000;0
1473;1461;39;0;0;0;0;.00nan;0;0
1473;2117;39;93;22;0;22;1.000;3600000;0
1474;1058;48;71;18;1;17;.944;3558000;0
1474;1155;48;0;0;0;0;.00nan;0;0
1474;1189;34;95;21;0;21;1.000;3600000;0
1474;2249;34;0;0;0;0;.00nan;0;0
1475;546;38;0;0;0;0;.00nan;0;0
1475;698;46;84;23;1;22;.957;3600000;0
1475;2426;46;0;0;0;0;.00nan;0;0
1475;2443;38;100;28;0;28;1.000;3600000;0
1476;235;61;0;0;0;0;.00nan;0;0
1476;268;54;0;0;0;0;.00nan;0;0
1476;330;54;83;28;1;27;.964;3600000;0
1476;635;61;68;30;3;27;.900;3529000;0
1477;195;60;68;29;3;26;.897;3551000;0
1477;860;60;0;0;0;0;.00nan;0;0
1477;2026;50;86;37;2;35;.946;3600000;0
1477;2377;50;0;0;0;0;.00nan;0;0
1478;157;52;100;35;0;35;1.000;3600000;0
1478;703;52;0;0;0;0;.00nan;0;0
1478;830;47;88;29;1;28;.966;3600000;0
1478;2247;47;0;0;0;0;.00nan;0;0
1479;263;57;67;18;1;17;.944;3600000;0
1479;543;43;0;0;0;0;.00nan;0;0
1479;713;57;0;0;0;0;.00nan;0;0
1479;1729;43;64;35;5;30;.857;3600000;0
1480;230;44;52;29;4;25;.862;3827000;0
1480;331;36;50;34;5;29;.853;3827000;0
1480;424;44;0;0;0;0;.00nan;0;0
1480;2367;36;0;0;0;0;.00nan;0;0
1481;475;40;0;0;0;0;.00nan;0;0
1481;1068;58;0;0;0;0;.00nan;0;0
1481;1333;58;74;37;4;33;.892;3600000;0
1481;2296;40;100;23;0;23;1.000;3600000;0
1482;29;37;56;22;3;19;.864;3552000;0
1482;102;59;59;19;2;17;.895;3600000;0
1482;2211;59;0;0;0;0;.00nan;0;0
1482;2360;37;0;0;0;0;.00nan;0;0
1483;664;41;0;0;0;0;.00nan;0;0
1483;673;41;86;44;4;40;.909;3900000;0
1483;1251;33;45;29;4;25;.862;3900000;0
1483;2031;33;0;0;0;0;.00nan;0;0
1484;1693;56;0;0;0;0;.00nan;0;0
1484;2052;62;0;0;0;0;.00nan;0;0
1484;2232;56;100;52;3;49;.942;3900000;0
1484;2374;62;43;20;3;17;.850;3900000;0
1485;501;49;100;25;0;25;1.000;3600000;0
1485;1189;34;68;36;3;33;.917;3600000;0
1485;1202;49;0;0;0;0;.00nan;0;0
1485;2249;34;0;0;0;0;.00nan;0;0
1486;235;61;56;32;4;28;.875;3900000;0
1486;268;54;64;34;4;30;.882;3900000;0
1486;330;54;0;0;0;0;.00nan;0;0
1486;635;61;0;0;0;0;.00nan;0;0
1487;193;45;65;35;3;32;.914;3600000;0
1487;575;63;0;0;0;0;.00nan;0;0
1487;1534;63;78;31;2;29;.935;3600000;0
1487;1747;45;0;0;0;0;.00nan;0;0
1488;195;60;0;0;0;0;.00nan;0;0
1488;860;60;83;17;0;17;1.000;3600000;0
1488;2026;50;0;0;0;0;.00nan;0;0
1488;2377;50;62;32;3;29;.906;3600000;0
1489;263;57;0;0;0;0;.00nan;0;0
1489;543;43;42;29;5;24;.828;3559000;0
1489;713;57;76;32;3;29;.906;3600000;0
1489;1729;43;0;0;0;0;.00nan;0;0
1490;230;44;0;0;0;0;.00nan;0;0
1490;331;36;0;0;0;0;.00nan;0;0
1490;424;44;60;24;2;22;.917;3554000;0
1490;2367;36;79;32;1;31;.969;3600000;0
1491;326;51;0;0;0;0;.00nan;0;0
1491;1082;51;92;45;3;42;.933;3520000;0
1491;1461;39;0;0;0;0;.00nan;0;0
1491;2117;39;69;23;1;22;.957;3600000;0
1492;235;61;100;31;0;31;1.000;3600000;0
1492;635;61;0;0;0;0;.00nan;0;0
1492;1058;48;0;0;0;0;.00nan;0;0
1492;1155;48;75;33;3;30;.909;3600000;0
1493;442;55;49;37;5;32;.865;3600000;0
1493;494;53;0;0;0;0;.00nan;0;0
1493;866;53;90;30;1;29;.967;3600000;0
1493;2076;55;0;0;0;0;.00nan;0;0
1494;193;45;85;29;1;28;.966;3600000;0
1494;475;40;56;23;3;20;.870;3567000;0
1494;1747;45;0;0;0;0;.00nan;0;0
1494;2296;40;0;0;0;0;.00nan;0;0
1495;102;59;55;25;3;22;.880;3544000;0
1495;1461;39;64;24;2;22;.917;3600000;0
1495;2117;39;0;0;0;0;.00nan;0;0
1495;2211;59;0;0;0;0;.00nan;0;0
1496;1068;58;78;25;2;23;.920;3551000;0
1496;1333;58;0;0;0;0;.00nan;0;0
1496;1693;56;100;29;1;28;.966;3600000;0
1496;2232;56;0;0;0;0;.00nan;0;0
1497;101;32;0;0;0;0;.00nan;0;0
1497;157;52;45;38;6;32;.842;3600000;0
1497;657;32;51;14;2;12;.857;3600000;0
1497;703;52;0;0;0;0;.00nan;0;0
1498;532;35;73;18;1;17;.944;3600000;0
1498;830;47;18;23;6;17;.739;2598000;0
1498;2176;35;0;0;0;0;.00nan;0;0
1498;2247;47;46;11;2;9;.818;1002000;0
1499;546;38;53;31;5;26;.839;3596000;0
1499;1687;42;0;0;0;0;.00nan;0;0
1499;2179;42;52;27;4;23;.852;3600000;0
1499;2443;38;0;0;0;0;.00nan;0;0
1500;1251;33;82;36;2;34;.944;3600000;0
1500;2026;50;77;25;1;24;.960;3600000;0
1500;2031;33;0;0;0;0;.00nan;0;0
1500;2377;50;0;0;0;0;.00nan;0;0
1501;230;44;0;0;0;0;.00nan;0;0
1501;424;44;28;24;5;19;.792;3525000;0
1501;475;40;64;27;3;24;.889;3600000;0
1501;2296;40;0;0;0;0;.00nan;0;0
1502;664;41;96;39;2;37;.949;3554000;0
1502;673;41;0;0;0;0;.00nan;0;0
1502;698;46;93;23;0;23;1.000;3600000;0
1502;2426;46;0;0;0;0;.00nan;0;0
1503;101;32;0;0;0;0;.00nan;0;0
1503;657;32;88;25;1;24;.960;3600000;0
1503;830;47;85;32;2;30;.938;3600000;0
1503;2247;47;0;0;0;0;.00nan;0;0
1504;1189;34;80;25;1;24;.960;3641000;0
1504;1461;39;0;0;0;0;.00nan;0;0
1504;2117;39;71;27;2;25;.926;3641000;0
1504;2249;34;0;0;0;0;.00nan;0;0
1505;546;38;0;0;0;0;.00nan;0;0
1505;1251;33;73;32;3;29;.906;3600000;0
1505;2031;33;0;0;0;0;.00nan;0;0
1505;2443;38;33;24;6;18;.750;3600000;0
1506;268;54;0;0;0;0;.00nan;0;0
1506;330;54;73;30;2;28;.933;3600000;0
1506;494;53;54;25;3;22;.880;3567000;0
1506;866;53;0;0;0;0;.00nan;0;0
1507;193;45;58;47;6;41;.872;3586000;0
1507;1747;45;0;0;0;0;.00nan;0;0
1507;2052;62;0;0;0;0;.00nan;0;0
1507;2374;62;55;24;3;21;.875;3600000;0
1508;235;61;79;27;2;25;.926;3563000;0
1508;635;61;0;0;0;0;.00nan;0;0
1508;1058;48;89;24;0;24;1.000;3600000;0
1508;1155;48;0;0;0;0;.00nan;0;0
1509;263;57;100;19;0;19;1.000;3600000;0
1509;575;63;51;28;4;24;.857;3600000;0
1509;713;57;0;0;0;0;.00nan;0;0
1509;1534;63;0;0;0;0;.00nan;0;0
1510;195;60;0;0;0;0;.00nan;0;0
1510;860;60;90;22;0;22;1.000;3600000;0
1510;1687;42;73;37;3;34;.919;3600000;0
1510;2179;42;0;0;0;0;.00nan;0;0
1511;29;37;64;21;2;19;.905;3600000;0
1511;501;49;77;43;3;40;.930;3569000;0
1511;1202;49;0;0;0;0;.00nan;0;0
1511;2360;37;0;0;0;0;.00nan;0;0
1512;442;55;0;0;0;0;.00nan;0;0
1512;1058;48;71;38;4;34;.895;3544000;0
1512;1155;48;0;0;0;0;.00nan;0;0
1512;2076;55;65;22;2;20;.909;3600000;0
1513;101;32;79;25;1;24;.960;3600000;0
1513;326;51;0;0;0;0;.00nan;0;0
1513;657;32;0;0;0;0;.00nan;0;0
1513;1082;51;73;25;2;23;.920;3548000;0
1514;230;44;0;0;0;0;.00nan;0;0
1514;424;44;88;34;3;31;.912;3600000;0
1514;475;40;0;0;0;0;.00nan;0;0
1514;2296;40;65;42;5;37;.881;3556000;0
1515;102;59;0;0;0;0;.00nan;0;0
1515;157;52;74;45;4;41;.911;3879000;0
1515;703;52;0;0;0;0;.00nan;0;0
1515;2211;59;50;29;4;25;.862;3900000;0
1516;664;41;0;0;0;0;.00nan;0;0
1516;673;41;88;43;3;40;.930;3863000;0
1516;698;46;80;34;2;32;.941;3863000;0
1516;2426;46;0;0;0;0;.00nan;0;0
1517;331;36;85;22;1;21;.955;3542000;0
1517;1693;56;100;33;0;33;1.000;3600000;0
1517;2232;56;0;0;0;0;.00nan;0;0
1517;2367;36;0;0;0;0;.00nan;0;0
1518;543;43;0;0;0;0;.00nan;0;0
1518;1068;58;0;0;0;0;.00nan;0;0
1518;1333;58;93;43;2;41;.953;3600000;0
1518;1729;43;60;21;3;18;.857;3562000;0
1519;532;35;44;21;4;17;.810;3600000;0
1519;830;47;89;39;3;36;.923;3600000;0
1519;2176;35;0;0;0;0;.00nan;0;0
1519;2247;47;0;0;0;0;.00nan;0;0
1520;501;49;0;0;0;0;.00nan;0;0
1520;1189;34;62;28;3;25;.893;3600000;0
1520;1202;49;59;41;5;36;.878;3600000;0
1520;2249;34;0;0;0;0;.00nan;0;0
1521;29;37;66;29;3;26;.897;3600000;0
1521;268;54;84;31;1;30;.968;3600000;0
1521;330;54;0;0;0;0;.00nan;0;0
1521;2360;37;0;0;0;0;.00nan;0;0
1522;235;61;0;0;0;0;.00nan;0;0
1522;494;53;0;0;0;0;.00nan;0;0
1522;635;61;50;23;3;20;.870;3802000;0
1522;866;53;81;29;2;27;.931;3802000;0
1523;193;45;80;35;2;33;.943;3140000;0
1523;1747;45;26;6;3;3;.500;460000;0
1523;2052;62;86;28;1;27;.964;3600000;0
1523;2374;62;0;0;0;0;.00nan;0;0
1524;263;57;34;20;4;16;.800;3545000;0
1524;575;63;0;0;0;0;.00nan;0;0
1524;713;57;0;0;0;0;.00nan;0;0
1524;1534;63;75;39;3;36;.923;3600000;0
1525;1687;42;0;0;0;0;.00nan;0;0
1525;2026;50;50;31;4;27;.871;3526000;0
1525;2179;42;94;43;2;41;.953;3600000;0
1525;2377;50;0;0;0;0;.00nan;0;0
1526;195;60;0;0;0;0;.00nan;0;0
1526;860;60;66;22;2;20;.909;3600000;0
1526;1251;33;52;9;1;8;.889;1478000;0
1526;2031;33;30;32;6;26;.813;2122000;0
1527;102;59;75;33;2;31;.939;3600000;0
1527;532;35;0;0;0;0;.00nan;0;0
1527;2176;35;50;29;4;25;.862;3561000;0
1527;2211;59;0;0;0;0;.00nan;0;0
1528;331;36;0;0;0;0;.00nan;0;0
1528;1693;56;0;0;0;0;.00nan;0;0
1528;2232;56;63;21;2;19;.905;3600000;0
1528;2367;36;64;31;3;28;.903;3553000;0
1529;1189;34;0;0;0;0;.00nan;0;0
1529;1461;39;100;23;0;23;1.000;3600000;0
1529;2117;39;0;0;0;0;.00nan;0;0
1529;2249;34;65;31;3;28;.903;3600000;0
1530;195;60;89;35;2;33;.943;3600000;0
1530;546;38;45;17;3;14;.824;3546000;0
1530;860;60;0;0;0;0;.00nan;0;0
1530;2443;38;0;0;0;0;.00nan;0;0
1531;546;38;0;0;0;0;.00nan;0;0
1531;664;41;82;39;3;36;.923;3900000;0
1531;673;41;0;0;0;0;.00nan;0;0
1531;2443;38;65;31;3;28;.903;3900000;0
1532;263;57;93;33;1;32;.970;3600000;0
1532;543;43;0;0;0;0;.00nan;0;0
1532;713;57;0;0;0;0;.00nan;0;0
1532;1729;43;57;30;4;26;.867;3600000;0
1533;29;37;76;27;2;25;.926;3900000;0
1533;501;49;83;35;2;33;.943;3900000;0
1533;1202;49;0;0;0;0;.00nan;0;0
1533;2360;37;0;0;0;0;.00nan;0;0
1534;102;59;23;27;6;21;.778;3264000;0
1534;235;61;56;30;4;26;.867;3600000;0
1534;635;61;0;0;0;0;.00nan;0;0
1534;2211;59;48;0;0;0;.00nan;251000;0
1535;331;36;94;24;0;24;1.000;3600000;0
1535;1068;58;0;0;0;0;.00nan;0;0
1535;1333;58;68;22;1;21;.955;3542000;0
1535;2367;36;0;0;0;0;.00nan;0;0
1536;532;35;85;27;1;26;.963;3612000;0
1536;830;47;81;30;2;28;.933;3612000;0
1536;2176;35;0;0;0;0;.00nan;0;0
1536;2247;47;0;0;0;0;.00nan;0;0
1537;575;63;56;43;6;37;.860;3105000;0
1537;1534;63;51;2;0;2;1.000;495000;0
1537;2052;62;0;0;0;0;.00nan;0;0
1537;2374;62;78;27;2;25;.926;3600000;0
1538;193;45;53;33;5;28;.848;3600000;0
1538;230;44;0;0;0;0;.00nan;0;0
1538;424;44;66;24;2;22;.917;3600000;0
1538;1747;45;0;0;0;0;.00nan;0;0
1539;195;60;74;27;2;25;.926;3551000;0
1539;860;60;0;0;0;0;.00nan;0;0
1539;1251;33;100;46;1;45;.978;3600000;0
1539;2031;33;0;0;0;0;.00nan;0;0
1540;442;55;30;15;4;11;.733;1038000;0
1540;1058;48;94;40;3;37;.925;3600000;0
1540;1155;48;0;0;0;0;.00nan;0;0
1540;2076;55;66;22;1;21;.955;2503000;0
1541;101;32;45;12;2;10;.833;3600000;0
1541;326;51;64;12;1;11;.917;1263000;0
1541;657;32;0;0;0;0;.00nan;0;0
1541;1082;51;57;37;5;32;.865;2337000;0
1542;331;36;100;25;0;25;1.000;3900000;0
1542;475;40;0;0;0;0;.00nan;0;0
1542;2296;40;90;23;0;23;1.000;3900000;0
1542;2367;36;0;0;0;0;.00nan;0;0
1543;546;38;55;24;3;21;.875;3900000;0
1543;664;41;73;32;3;29;.906;3900000;0
1543;673;41;0;0;0;0;.00nan;0;0
1543;2443;38;0;0;0;0;.00nan;0;0
1544;575;63;0;0;0;0;.00nan;0;0
1544;1068;58;73;25;2;23;.920;3563000;0
1544;1333;58;0;0;0;0;.00nan;0;0
1544;1534;63;100;31;1;30;.968;3600000;0
1545;235;61;94;39;2;37;.949;3614000;0
1545;532;35;82;27;1;26;.963;3614000;0
1545;635;61;0;0;0;0;.00nan;0;0
1545;2176;35;0;0;0;0;.00nan;0;0
1546;494;53;0;0;0;0;.00nan;0;0
1546;866;53;82;22;1;21;.955;3600000;0
1546;1189;34;89;41;2;39;.951;3569000;0
1546;2249;34;0;0;0;0;.00nan;0;0
1547;698;46;67;30;3;27;.900;3577000;0
1547;1687;42;83;29;2;27;.931;3600000;0
1547;2179;42;0;0;0;0;.00nan;0;0
1547;2426;46;0;0;0;0;.00nan;0;0
1548;29;37;40;20;4;16;.800;3596000;0
1548;268;54;0;0;0;0;.00nan;0;0
1548;330;54;96;41;2;39;.951;3600000;0
1548;2360;37;0;0;0;0;.00nan;0;0
1549;543;43;94;35;2;33;.943;3581000;0
1549;1729;43;0;0;0;0;.00nan;0;0
1549;2052;62;0;0;0;0;.00nan;0;0
1549;2374;62;100;35;0;35;1.000;3600000;0
1550;157;52;21;11;4;7;.636;1124000;0
1550;703;52;58;15;2;13;.867;2389000;0
1550;830;47;0;0;0;0;.00nan;0;0
1550;2247;47;69;33;4;29;.879;3600000;0
1551;230;44;0;0;0;0;.00nan;0;0
1551;263;57;73;30;2;28;.933;3600000;0
1551;424;44;70;34;3;31;.912;3600000;0
1551;713;57;0;0;0;0;.00nan;0;0
1552;326;51;0;0;0;0;.00nan;0;0
1552;532;35;0;0;0;0;.00nan;0;0
1552;1082;51;80;38;3;35;.921;3581000;0
1552;2176;35;56;18;2;16;.889;3600000;0
1553;331;36;55;24;3;21;.875;3676000;0
1553;475;40;78;35;4;31;.886;3676000;0
1553;2296;40;0;0;0;0;.00nan;0;0
1553;2367;36;0;0;0;0;.00nan;0;0
1554;102;59;19;32;7;25;.781;3074000;0
1554;1693;56;66;22;2;20;.909;3600000;0
1554;2211;59;33;5;2;3;.600;526000;0
1554;2232;56;0;0;0;0;.00nan;0;0
1555;546;38;0;0;0;0;.00nan;0;0
1555;664;41;0;0;0;0;.00nan;0;0
1555;673;41;59;20;2;18;.900;3600000;0
1555;2443;38;79;39;3;36;.923;3594000;0
1556;193;45;75;32;3;29;.906;3600000;0
1556;1068;58;0;0;0;0;.00nan;0;0
1556;1333;58;100;29;0;29;1.000;3600000;0
1556;1747;45;0;0;0;0;.00nan;0;0
1557;101;32;0;0;0;0;.00nan;0;0
1557;235;61;0;0;0;0;.00nan;0;0
1557;635;61;84;27;1;26;.963;3600000;0
1557;657;32;75;33;3;30;.909;3572000;0
1558;494;53;89;33;2;31;.939;3600000;0
1558;866;53;0;0;0;0;.00nan;0;0
1558;1189;34;0;0;0;0;.00nan;0;0
1558;2249;34;67;30;4;26;.867;3568000;0
1559;268;54;54;24;3;21;.875;3900000;0
1559;330;54;0;0;0;0;.00nan;0;0
1559;501;49;0;0;0;0;.00nan;0;0
1559;1202;49;87;34;3;31;.912;3900000;0
1560;1461;39;69;31;2;29;.935;3600000;0
1560;2026;50;0;0;0;0;.00nan;0;0
1560;2117;39;0;0;0;0;.00nan;0;0
1560;2377;50;74;36;3;33;.917;3592000;0
1561;29;37;0;0;0;0;.00nan;0;0
1561;1058;48;0;0;0;0;.00nan;0;0
1561;1155;48;46;26;4;22;.846;3900000;0
1561;2360;37;87;46;4;42;.913;3900000;0
1562;157;52;51;23;3;20;.870;3600000;0
1562;703;52;0;0;0;0;.00nan;0;0
1562;830;47;84;41;2;39;.951;3600000;0
1562;2247;47;0;0;0;0;.00nan;0;0
1563;230;44;0;0;0;0;.00nan;0;0
1563;263;57;0;0;0;0;.00nan;0;0
1563;424;44;85;26;0;26;1.000;3900000;0
1563;713;57;100;38;0;38;1.000;3900000;0
1564;195;60;97;35;1;34;.971;3600000;0
1564;860;60;0;0;0;0;.00nan;0;0
1564;1251;33;78;37;3;34;.919;3523000;0
1564;2031;33;0;0;0;0;.00nan;0;0
1565;102;59;48;5;1;4;.800;824000;0
1565;1693;56;0;0;0;0;.00nan;0;0
1565;2211;59;32;34;7;27;.794;2776000;0
1565;2232;56;82;29;2;27;.931;3600000;0
1566;698;46;55;37;5;32;.865;3600000;0
1566;1687;42;0;0;0;0;.00nan;0;0
1566;2179;42;61;28;4;24;.857;3600000;0
1566;2426;46;0;0;0;0;.00nan;0;0
1567;543;43;0;0;0;0;.00nan;0;0
1567;1729;43;87;40;3;37;.925;3550000;0
1567;2052;62;0;0;0;0;.00nan;0;0
1567;2374;62;72;22;2;20;.909;3600000;0
1568;1461;39;0;0;0;0;.00nan;0;0
1568;2026;50;70;26;3;23;.885;3600000;0
1568;2117;39;49;35;4;31;.886;3587000;0
1568;2377;50;0;0;0;0;.00nan;0;0
1569;501;49;94;45;2;43;.956;3600000;0
1569;1058;48;71;40;4;36;.900;3573000;0
1569;1155;48;0;0;0;0;.00nan;0;0
1569;1202;49;0;0;0;0;.00nan;0;0
1570;475;40;0;0;0;0;.00nan;0;0
1570;575;63;92;37;2;35;.946;3900000;0
1570;1534;63;0;0;0;0;.00nan;0;0
1570;2296;40;87;38;2;36;.947;3900000;0
1571;263;57;0;0;0;0;.00nan;0;0
1571;543;43;90;32;2;30;.938;3600000;0
1571;713;57;57;29;3;26;.897;3585000;0
1571;1729;43;0;0;0;0;.00nan;0;0
1572;326;51;92;54;4;50;.926;3600000;0
1572;1082;51;0;0;0;0;.00nan;0;0
1572;1189;34;67;30;2;28;.933;3600000;0
1572;2249;34;0;0;0;0;.00nan;0;0
1573;475;40;62;25;3;22;.880;3545000;0
1573;575;63;0;0;0;0;.00nan;0;0
1573;1534;63;98;45;2;43;.956;3600000;0
1573;2296;40;0;0;0;0;.00nan;0;0
1574;101;32;60;29;3;26;.897;3600000;0
1574;157;52;0;0;0;0;.00nan;0;0
1574;657;32;0;0;0;0;.00nan;0;0
1574;703;52;79;31;2;29;.935;3600000;0
1575;532;35;73;38;4;34;.895;3600000;0
1575;1461;39;75;33;2;31;.939;3600000;0
1575;2117;39;0;0;0;0;.00nan;0;0
1575;2176;35;0;0;0;0;.00nan;0;0
1576;494;53;0;0;0;0;.00nan;0;0
1576;501;49;0;0;0;0;.00nan;0;0
1576;866;53;75;32;3;29;.906;3545000;0
1576;1202;49;74;29;2;27;.931;3600000;0
1577;235;61;0;0;0;0;.00nan;0;0
1577;635;61;94;31;1;30;.968;3600000;0
1577;830;47;33;34;7;27;.794;3600000;0
1577;2247;47;0;0;0;0;.00nan;0;0
1578;442;55;85;29;3;26;.897;3600000;0
1578;830;47;28;16;5;11;.688;1581000;0
1578;2076;55;0;0;0;0;.00nan;0;0
1578;2247;47;52;27;3;24;.889;2019000;0
1579;268;54;0;0;0;0;.00nan;0;0
1579;326;51;0;0;0;0;.00nan;0;0
1579;330;54;59;30;4;26;.867;3600000;0
1579;1082;51;61;42;5;37;.881;3600000;0
1580;102;59;61;32;4;28;.875;3713000;0
1580;1461;39;0;0;0;0;.00nan;0;0
1580;2117;39;61;35;5;30;.857;3713000;0
1580;2211;59;0;0;0;0;.00nan;0;0
1581;193;45;75;23;1;22;.957;3600000;0
1581;664;41;61;38;5;33;.868;3600000;0
1581;673;41;0;0;0;0;.00nan;0;0
1581;1747;45;0;0;0;0;.00nan;0;0
1582;263;57;83;26;2;24;.923;3600000;0
1582;713;57;0;0;0;0;.00nan;0;0
1582;1693;56;46;29;4;25;.862;3530000;0
1582;2232;56;0;0;0;0;.00nan;0;0
1583;101;32;24;22;6;16;.727;1389000;0
1583;532;35;70;25;2;23;.920;3600000;0
1583;657;32;43;17;3;14;.824;2211000;0
1583;2176;35;0;0;0;0;.00nan;0;0
1584;195;60;100;28;0;28;1.000;3600000;0
1584;546;38;83;32;2;30;.938;3570000;0
1584;860;60;0;0;0;0;.00nan;0;0
1584;2443;38;0;0;0;0;.00nan;0;0
1585;29;37;91;38;2;36;.947;3594000;0
1585;698;46;74;26;1;25;.962;3600000;0
1585;2360;37;0;0;0;0;.00nan;0;0
1585;2426;46;0;0;0;0;.00nan;0;0
1586;235;61;47;28;4;24;.857;3600000;0
1586;494;53;79;22;1;21;.955;3600000;0
1586;635;61;0;0;0;0;.00nan;0;0
1586;866;53;0;0;0;0;.00nan;0;0
1587;230;44;0;0;0;0;.00nan;0;0
1587;424;44;69;32;3;29;.906;3522000;0
1587;2052;62;0;0;0;0;.00nan;0;0
1587;2374;62;87;33;1;32;.970;3600000;0
1588;1687;42;0;0;0;0;.00nan;0;0
1588;2026;50;93;33;1;32;.970;3600000;0
1588;2179;42;60;22;2;20;.909;3547000;0
1588;2377;50;0;0;0;0;.00nan;0;0
1589;331;36;59;32;4;28;.875;3548000;0
1589;1251;33;82;30;2;28;.933;3600000;0
1589;2031;33;0;0;0;0;.00nan;0;0
1589;2367;36;0;0;0;0;.00nan;0;0
1590;235;61;0;0;0;0;.00nan;0;0
1590;442;55;35;5;2;3;.600;940000;0
1590;635;61;78;35;3;32;.914;3600000;0
1590;2076;55;44;35;6;29;.829;2660000;0
1591;326;51;63;36;4;32;.889;3595000;0
1591;1082;51;0;0;0;0;.00nan;0;0
1591;1189;34;53;25;3;22;.880;3600000;0
1591;2249;34;0;0;0;0;.00nan;0;0
1592;475;40;35;25;5;20;.800;3533000;0
1592;1068;58;0;0;0;0;.00nan;0;0
1592;1333;58;74;29;3;26;.897;3600000;0
1592;2296;40;0;0;0;0;.00nan;0;0
1593;575;63;68;38;4;34;.895;3577000;0
1593;664;41;67;24;2;22;.917;3600000;0
1593;673;41;0;0;0;0;.00nan;0;0
1593;1534;63;0;0;0;0;.00nan;0;0
1594;263;57;0;0;0;0;.00nan;0;0
1594;713;57;75;31;2;29;.935;3900000;0
1594;1693;56;0;0;0;0;.00nan;0;0
1594;2232;56;65;27;2;25;.926;3900000;0
1595;101;32;80;21;1;20;.952;3600000;0
1595;532;35;0;0;0;0;.00nan;0;0
1595;657;32;0;0;0;0;.00nan;0;0
1595;2176;35;29;16;4;12;.750;3600000;0
1596;546;38;0;0;0;0;.00nan;0;0
1596;2026;50;0;0;0;0;.00nan;0;0
1596;2377;50;54;36;5;31;.861;3519000;0
1596;2443;38;75;29;3;26;.897;3600000;0
1597;29;37;69;32;3;29;.906;3839000;0
1597;698;46;0;0;0;0;.00nan;0;0
1597;2360;37;0;0;0;0;.00nan;0;0
1597;2426;46;67;33;4;29;.879;3839000;0
1598;268;54;47;25;4;21;.840;3600000;0
1598;330;54;0;0;0;0;.00nan;0;0
1598;501;49;38;28;5;23;.821;3550000;0
1598;1202;49;0;0;0;0;.00nan;0;0
1599;494;53;0;0;0;0;.00nan;0;0
1599;830;47;0;0;0;0;.00nan;0;0
1599;866;53;79;12;0;12;1.000;3600000;0
1599;2247;47;97;46;2;44;.957;3572000;0
1600;230;44;0;0;0;0;.00nan;0;0
1600;424;44;87;40;3;37;.925;3842000;0
1600;2052;62;64;34;4;30;.882;3842000;0
1600;2374;62;0;0;0;0;.00nan;0;0
1601;193;45;0;0;0;0;.00nan;0;0
1601;543;43;0;0;0;0;.00nan;0;0
1601;1729;43;81;14;0;14;1.000;3600000;0
1601;1747;45;50;26;4;22;.846;3600000;0
1602;157;52;56;32;3;29;.906;3900000;0
1602;703;52;0;0;0;0;.00nan;0;0
1602;1058;48;75;29;3;26;.897;3900000;0
1602;1155;48;0;0;0;0;.00nan;0;0
1603;195;60;67;24;2;22;.917;3600000;0
1603;860;60;0;0;0;0;.00nan;0;0
1603;1687;42;46;33;6;27;.818;3600000;0
1603;2179;42;0;0;0;0;.00nan;0;0
1604;268;54;0;0;0;0;.00nan;0;0
1604;330;54;40;24;4;20;.833;3600000;0
1604;1189;34;0;0;0;0;.00nan;0;0
1604;2249;34;77;22;1;21;.955;3600000;0
1605;195;60;0;0;0;0;.00nan;0;0
1605;546;38;51;32;5;27;.844;3554000;0
1605;860;60;71;28;3;25;.893;3600000;0
1605;2443;38;0;0;0;0;.00nan;0;0
1606;1461;39;0;0;0;0;.00nan;0;0
1606;1687;42;0;0;0;0;.00nan;0;0
1606;2117;39;69;25;2;23;.920;3600000;0
1606;2179;42;70;39;4;35;.897;3600000;0
1607;157;52;0;0;0;0;.00nan;0;0
1607;703;52;98;36;1;35;.972;3600000;0
1607;1058;48;0;0;0;0;.00nan;0;0
1607;1155;48;68;22;2;20;.909;3600000;0
1608;331;36;97;35;1;34;.971;3900000;0
1608;1251;33;100;42;1;41;.976;3900000;0
1608;2031;33;0;0;0;0;.00nan;0;0
1608;2367;36;0;0;0;0;.00nan;0;0
1609;193;45;42;33;5;28;.848;3545000;0
1609;664;41;47;26;4;22;.846;3600000;0
1609;673;41;0;0;0;0;.00nan;0;0
1609;1747;45;0;0;0;0;.00nan;0;0
1610;1461;39;79;41;3;38;.927;3600000;0
1610;2026;50;31;25;5;20;.800;3571000;0
1610;2117;39;0;0;0;0;.00nan;0;0
1610;2377;50;0;0;0;0;.00nan;0;0
1611;230;44;61;27;3;24;.889;3600000;0
1611;424;44;0;0;0;0;.00nan;0;0
1611;575;63;53;4;0;4;1.000;562000;0
1611;1534;63;39;34;6;28;.824;3038000;0
4729;157;52;94;53;4;49;.925;3900000;0
4729;543;43;91;39;4;35;.897;3858800;0
4729;703;52;0;0;0;0;.00nan;0;0
4729;2398;43;0;0;0;0;.00nan;0;0
4731;442;55;52;26;4;22;.846;3527150;0
4731;1129;33;100;49;2;47;.959;3600000;0
4731;2076;55;0;0;0;0;.00nan;0;0
4731;2157;33;0;0;0;0;.00nan;0;0
4733;532;35;92;29;1;28;.966;3579900;0
4733;1068;58;0;0;0;0;.00nan;0;0
4733;1333;58;100;27;0;27;1.000;3600000;0
4733;2176;35;0;0;0;0;.00nan;0;0
4735;697;39;83;33;3;30;.909;3804150;0
4735;1364;47;66;32;4;28;.875;3804150;0
4735;2247;47;0;0;0;0;.00nan;0;0
4735;2248;39;0;0;0;0;.00nan;0;0
4737;195;60;84;28;2;26;.929;3900000;0
4737;860;60;0;0;0;0;.00nan;0;0
4737;967;50;98;49;2;47;.959;3900000;0
4737;2377;50;0;0;0;0;.00nan;0;0
4739;102;59;54;26;4;22;.846;3547250;0
4739;664;41;86;38;3;35;.921;3600000;0
4739;673;41;0;0;0;0;.00nan;0;0
4739;2211;59;0;0;0;0;.00nan;0;0
4741;101;32;66;28;3;25;.893;2764100;0
4741;2231;37;0;0;0;0;.00nan;0;0
4741;2360;37;91;17;0;17;1.000;3600000;0
4741;2427;32;16;12;5;7;.583;835900;0
4743;268;54;0;0;0;0;.00nan;0;0
4743;494;53;0;0;0;0;.00nan;0;0
4743;951;53;70;23;2;21;.913;3541350;0
4743;1001;54;78;20;1;19;.950;3600000;0
4745;501;49;0;0;0;0;.00nan;0;0
4745;869;56;100;36;0;36;1.000;3600000;0
4745;1202;49;46;23;4;19;.826;3600000;0
4745;2232;56;0;0;0;0;.00nan;0;0
4747;206;62;0;0;0;0;.00nan;0;0
4747;668;40;0;0;0;0;.00nan;0;0
4747;2296;40;100;34;1;33;.971;3600000;0
4747;2374;62;89;46;3;43;.935;3600000;0
4749;713;57;89;41;3;38;.927;3600000;0
4749;1748;57;0;0;0;0;.00nan;0;0
4749;2281;46;99;40;2;38;.950;3600000;0
4749;2426;46;0;0;0;0;.00nan;0;0
4751;331;36;72;23;2;21;.913;3600000;0
4751;1058;48;0;0;0;0;.00nan;0;0
4751;1155;48;57;29;4;25;.862;3519250;0
4751;2367;36;0;0;0;0;.00nan;0;0
4753;230;44;94;36;2;34;.944;3600000;0
4753;575;63;93;43;3;40;.930;3600000;0
4753;1534;63;0;0;0;0;.00nan;0;0
4753;2279;44;0;0;0;0;.00nan;0;0
4755;127;61;68;33;4;29;.879;3900000;0
4755;635;61;0;0;0;0;.00nan;0;0
4755;1189;34;82;44;4;40;.909;3884750;0
4755;2249;34;0;0;0;0;.00nan;0;0
4757;890;51;67;27;3;24;.889;3600000;0
4757;1238;38;72;35;4;31;.886;3600000;0
4757;2268;51;0;0;0;0;.00nan;0;0
4757;2443;38;0;0;0;0;.00nan;0;0
4759;396;45;0;0;0;0;.00nan;0;0
4759;995;42;41;24;5;19;.792;3600000;0
4759;2179;42;0;0;0;0;.00nan;0;0
4759;2204;45;62;44;6;38;.864;3566650;0
2464;3043;102;32;14;4;10;.714;1188150;0
2464;3141;105;60;40;6;34;.850;3900000;0
2464;3435;102;82;26;2;24;.923;2711850;0
2464;4873;105;0;0;0;0;.00nan;0;0
2465;3111;90;79;41;4;37;.902;3600000;0
2465;3147;87;100;34;1;33;.971;3600000;0
2465;3217;90;0;0;0;0;.00nan;0;0
2465;3299;87;0;0;0;0;.00nan;0;0
2466;3193;91;0;0;0;0;.00nan;0;0
2466;3273;95;0;0;0;0;.00nan;0;0
2466;3316;95;58;35;5;30;.857;3600000;0
2466;5262;91;77;33;3;30;.909;3600000;0
2467;3266;86;44;34;6;28;.824;3600000;0
2467;3270;93;79;34;3;31;.912;3600000;0
2467;3312;86;0;0;0;0;.00nan;0;0
2467;3394;93;0;0;0;0;.00nan;0;0
2468;2991;96;39;24;5;19;.792;3582500;0
2468;3029;98;62;24;3;21;.875;3600000;0
2468;3246;96;0;0;0;0;.00nan;0;0
2468;3472;98;0;0;0;0;.00nan;0;0
2469;3159;97;81;23;1;22;.957;3600000;0
2469;3323;97;0;0;0;0;.00nan;0;0
2469;3360;100;54;38;6;32;.842;3600000;0
2469;5260;100;0;0;0;0;.00nan;0;0
2470;3215;101;0;0;0;0;.00nan;0;0
2470;3229;101;41;20;4;16;.800;3563000;0
2470;3410;99;74;29;3;26;.897;3600000;0
2470;5261;99;0;0;0;0;.00nan;0;0
2471;3111;90;0;0;0;0;.00nan;0;0
2471;3217;90;69;32;4;28;.875;3600000;0
2471;3228;92;21;9;4;5;.556;1195500;0
2471;3429;92;35;11;3;8;.727;2404500;0
2472;3104;94;84;25;1;24;.960;3600000;0
2472;3417;89;79;34;3;31;.912;3533100;0
2472;4750;94;0;0;0;0;.00nan;0;0
2472;5200;89;0;0;0;0;.00nan;0;0
2473;3022;88;46;5;1;4;.800;606050;0
2473;3136;88;27;22;6;16;.727;2993950;0
2473;3147;87;75;31;3;28;.903;3600000;0
2473;3299;87;0;0;0;0;.00nan;0;0
2474;3006;103;85;31;2;29;.935;3600000;0
2474;3141;105;47;29;5;24;.828;3600000;0
2474;3440;103;0;0;0;0;.00nan;0;0
2474;4873;105;0;0;0;0;.00nan;0;0
2475;3034;104;0;0;0;0;.00nan;0;0
2475;3043;102;78;37;4;33;.892;3900000;0
2475;3272;104;96;52;4;48;.923;3900000;0
2475;3435;102;0;0;0;0;.00nan;0;0
2476;3193;91;80;35;3;32;.914;3594050;0
2476;3228;92;97;36;2;34;.944;3600000;0
2476;3429;92;0;0;0;0;.00nan;0;0
2476;5262;91;0;0;0;0;.00nan;0;0
2477;2991;96;76;47;6;41;.872;3117450;0
2477;3246;96;63;7;0;7;1.000;782550;0
2477;3270;93;0;0;0;0;.00nan;0;0
2477;3394;93;20;20;6;14;.700;3900000;0
2478;3022;88;73;43;5;38;.884;3600000;0
2478;3136;88;0;0;0;0;.00nan;0;0
2478;3266;86;81;29;2;27;.931;3600000;0
2478;3312;86;0;0;0;0;.00nan;0;0
2479;3159;97;52;32;5;27;.844;3600000;0
2479;3323;97;0;0;0;0;.00nan;0;0
2479;3360;100;99;34;1;33;.971;3600000;0
2479;5260;100;0;0;0;0;.00nan;0;0
2480;3029;98;100;41;2;39;.951;3600000;0
2480;3141;105;67;34;4;30;.882;3581100;0
2480;3472;98;0;0;0;0;.00nan;0;0
2480;4873;105;0;0;0;0;.00nan;0;0
2481;3215;101;59;16;2;14;.875;3600000;0
2481;3229;101;0;0;0;0;.00nan;0;0
2481;3410;99;91;47;4;43;.915;3568800;0
2481;5261;99;0;0;0;0;.00nan;0;0
2482;3006;103;69;22;2;20;.909;3600000;0
2482;3043;102;0;0;0;0;.00nan;0;0
2482;3435;102;81;36;3;33;.917;3570800;0
2482;3440;103;0;0;0;0;.00nan;0;0
2483;3034;104;0;0;0;0;.00nan;0;0
2483;3272;104;100;28;0;28;1.000;3600000;0
2483;3273;95;85;41;4;37;.902;3600000;0
2483;3316;95;0;0;0;0;.00nan;0;0
2484;3104;94;66;21;2;19;.905;3571900;0
2484;3147;87;0;0;0;0;.00nan;0;0
2484;3299;87;100;46;1;45;.978;3600000;0
2484;4750;94;0;0;0;0;.00nan;0;0
2485;3022;88;0;0;0;0;.00nan;0;0
2485;3136;88;66;33;4;29;.879;3576900;0
2485;3417;89;69;22;2;20;.909;3600000;0
2485;5200;89;0;0;0;0;.00nan;0;0
2486;3193;91;56;34;5;29;.853;3512050;0
2486;3270;93;0;0;0;0;.00nan;0;0
2486;3394;93;92;41;3;38;.927;3600000;0
2486;5262;91;0;0;0;0;.00nan;0;0
2487;3111;90;0;0;0;0;.00nan;0;0
2487;3217;90;65;25;3;22;.880;3600000;0
2487;3228;92;0;0;0;0;.00nan;0;0
2487;3429;92;62;32;4;28;.875;3555750;0
2488;3034;104;0;0;0;0;.00nan;0;0
2488;3141;105;58;28;4;24;.857;3600000;0
2488;3272;104;59;35;5;30;.857;3597400;0
2488;4873;105;0;0;0;0;.00nan;0;0
2489;3266;86;85;35;3;32;.914;3600000;0
2489;3312;86;0;0;0;0;.00nan;0;0
2489;3360;100;0;0;0;0;.00nan;0;0
2489;5260;100;39;25;5;20;.800;3516550;0
2490;2991;96;41;26;5;21;.808;3900000;0
2490;3246;96;0;0;0;0;.00nan;0;0
2490;3410;99;60;34;5;29;.853;3900000;0
2490;5261;99;0;0;0;0;.00nan;0;0
2491;3034;104;92;35;2;33;.943;3600000;0
2491;3159;97;0;0;0;0;.00nan;0;0
2491;3272;104;0;0;0;0;.00nan;0;0
2491;3323;97;70;30;3;27;.900;3583600;0
2492;3029;98;84;43;4;39;.907;3572700;0
2492;3215;101;75;31;3;28;.903;3600000;0
2492;3229;101;0;0;0;0;.00nan;0;0
2492;3472;98;0;0;0;0;.00nan;0;0
2493;3147;87;100;40;0;40;1.000;3600000;0
2493;3228;92;43;31;6;25;.806;3600000;0
2493;3299;87;0;0;0;0;.00nan;0;0
2493;3429;92;0;0;0;0;.00nan;0;0
2494;3022;88;37;23;5;18;.783;3583100;0
2494;3104;94;43;20;4;16;.800;3600000;0
2494;3136;88;0;0;0;0;.00nan;0;0
2494;4750;94;0;0;0;0;.00nan;0;0
2495;3111;90;0;0;0;0;.00nan;0;0
2495;3217;90;57;34;5;29;.853;3600000;0
2495;3273;95;40;35;7;28;.800;3568800;0
2495;3316;95;0;0;0;0;.00nan;0;0
2496;3006;103;57;28;4;24;.857;3584700;0
2496;3043;102;96;47;3;44;.936;3600000;0
2496;3435;102;0;0;0;0;.00nan;0;0
2496;3440;103;0;0;0;0;.00nan;0;0
2497;3193;91;77;21;1;20;.952;3600000;0
2497;3273;95;0;0;0;0;.00nan;0;0
2497;3316;95;69;35;4;31;.886;3600000;0
2497;5262;91;0;0;0;0;.00nan;0;0
2498;3270;93;0;0;0;0;.00nan;0;0
2498;3394;93;91;28;1;27;.964;3600000;0
2498;3410;99;0;0;0;0;.00nan;0;0
2498;5261;99;73;44;6;38;.864;3600000;0
2499;3141;105;86;26;1;25;.962;3600000;0
2499;3266;86;53;3;0;3;1.000;1275450;0
2499;3312;86;45;33;6;27;.818;2324550;0
2499;4873;105;0;0;0;0;.00nan;0;0
2500;2991;96;0;0;0;0;.00nan;0;0
2500;3043;102;0;0;0;0;.00nan;0;0
2500;3246;96;79;32;3;29;.906;3600000;0
2500;3435;102;41;20;4;16;.800;3561900;0
2501;3029;98;65;33;4;29;.879;3577950;0
2501;3360;100;85;31;2;29;.935;3600000;0
2501;3472;98;0;0;0;0;.00nan;0;0
2501;5260;100;0;0;0;0;.00nan;0;0
2502;3006;103;0;0;0;0;.00nan;0;0
2502;3215;101;90;40;3;37;.925;3600000;0
2502;3229;101;0;0;0;0;.00nan;0;0
2502;3440;103;71;36;4;32;.889;3549950;0
2503;3228;92;0;0;0;0;.00nan;0;0
2503;3417;89;63;30;4;26;.867;3744700;0
2503;3429;92;68;40;5;35;.875;3744700;0
2503;5200;89;0;0;0;0;.00nan;0;0
2504;3022;88;74;31;3;28;.903;3600000;0
2504;3136;88;0;0;0;0;.00nan;0;0
2504;3193;91;0;0;0;0;.00nan;0;0
2504;3215;91;61;31;4;27;.871;3600000;0
2505;3104;94;100;41;1;40;.976;3600000;0
2505;3270;93;34;22;5;17;.773;3600000;0
2505;3394;93;0;0;0;0;.00nan;0;0
2505;4750;94;0;0;0;0;.00nan;0;0
2506;3029;98;0;0;0;0;.00nan;0;0
2506;3159;97;67;27;3;24;.889;3600000;0
2506;3323;97;0;0;0;0;.00nan;0;0
2506;3472;98;63;38;5;33;.868;3581550;0
2507;3147;87;91;50;4;46;.920;3900000;0
2507;3299;87;0;0;0;0;.00nan;0;0
2507;3417;89;0;0;0;0;.00nan;0;0
2507;5200;89;66;34;4;30;.882;3900000;0
2508;3006;103;80;53;6;47;.887;3600000;0
2508;3034;104;0;0;0;0;.00nan;0;0
2508;3272;104;55;33;5;28;.848;3600000;0
2508;3440;103;0;0;0;0;.00nan;0;0
2509;3006;103;59;29;4;25;.862;3575900;0
2509;3266;86;87;30;2;28;.933;3600000;0
2509;3312;86;0;0;0;0;.00nan;0;0
2509;3440;103;0;0;0;0;.00nan;0;0
2510;3029;98;43;21;4;17;.810;1077700;0
2510;3229;101;57;16;2;14;.875;3600000;0
2510;3314;101;0;0;0;0;.00nan;0;0
2510;3472;98;79;23;1;22;.957;2522300;0
2511;3360;100;37;29;6;23;.793;3566800;0
2511;3410;99;30;13;4;9;.692;1188050;0
2511;5260;100;0;0;0;0;.00nan;0;0
2511;5261;99;74;17;1;16;.941;2411950;0
2512;3111;90;30;26;6;20;.769;3600000;0
2512;3217;90;0;0;0;0;.00nan;0;0
2512;3273;95;83;22;1;21;.955;3600000;0
2512;3316;95;0;0;0;0;.00nan;0;0
2513;3193;91;39;35;6;29;.829;2698000;0
2513;3215;91;55;6;0;6;1.000;902000;0
2513;3410;99;95;21;0;21;1.000;3600000;0
2513;5261;99;0;0;0;0;.00nan;0;0
2514;3141;105;0;0;0;0;.00nan;0;0
2514;3270;93;0;0;0;0;.00nan;0;0
2514;3394;93;78;33;3;30;.909;3600000;0
2514;4873;105;26;21;5;16;.762;3577000;0
2515;3266;86;83;33;2;31;.939;3600000;0
2515;3312;86;0;0;0;0;.00nan;0;0
2515;3417;89;37;29;6;23;.793;3600000;0
2515;5200;89;0;0;0;0;.00nan;0;0
2516;2991;96;58;29;3;26;.897;3600000;0
2516;3228;92;60;36;4;32;.889;3600000;0
2516;3246;96;0;0;0;0;.00nan;0;0
2516;3429;92;0;0;0;0;.00nan;0;0
2517;3111;90;0;0;0;0;.00nan;0;0
2517;3159;97;82;32;2;30;.938;3600000;0
2517;3217;90;46;35;6;29;.829;3600000;0
2517;3323;97;0;0;0;0;.00nan;0;0
2518;3029;98;34;46;9;37;.804;3600000;0
2518;3034;104;0;0;0;0;.00nan;0;0
2518;3272;104;78;24;1;23;.958;3600000;0
2518;3472;98;0;0;0;0;.00nan;0;0
2519;3104;94;33;16;4;12;.750;3600000;0
2519;3360;100;60;6;0;6;1.000;334000;0
2519;4750;94;0;0;0;0;.00nan;0;0
2519;5260;100;34;36;6;30;.833;3246000;0
2520;3147;87;43;22;4;18;.818;1164000;0
2520;3273;95;0;0;0;0;.00nan;0;0
2520;3299;87;59;11;1;10;.909;2462000;0
2520;3316;95;45;34;6;28;.824;3626000;0
2521;3006;103;0;0;0;0;.00nan;0;0
2521;3022;88;0;0;0;0;.00nan;0;0
2521;3136;88;77;31;2;29;.935;3600000;0
2521;3440;103;60;27;3;24;.889;3551000;0
2522;3193;91;0;0;0;0;.00nan;0;0
2522;3215;91;62;14;1;13;.929;3900000;0
2522;3270;93;83;30;1;29;.967;3900000;0
2522;3394;93;0;0;0;0;.00nan;0;0
2523;3147;87;46;38;6;32;.842;3600000;0
2523;3266;86;88;39;2;37;.949;3600000;0
2523;3299;87;0;0;0;0;.00nan;0;0
2523;3312;86;0;0;0;0;.00nan;0;0
2524;2991;96;0;0;0;0;.00nan;0;0
2524;3141;105;98;34;1;33;.971;3600000;0
2524;3246;96;78;37;3;34;.919;3545000;0
2524;4873;105;0;0;0;0;.00nan;0;0
2525;3159;97;0;0;0;0;.00nan;0;0
2525;3323;97;91;38;2;36;.947;3600000;0
2525;3410;99;60;38;4;34;.895;3540000;0
2525;5261;99;0;0;0;0;.00nan;0;0
2526;3029;98;0;0;0;0;.00nan;0;0
2526;3043;102;83;37;3;34;.919;3600000;0
2526;3435;102;0;0;0;0;.00nan;0;0
2526;3472;98;62;28;4;24;.857;3559000;0
2527;3022;88;45;32;6;26;.813;3593000;0
2527;3136;88;0;0;0;0;.00nan;0;0
2527;3229;101;34;29;5;24;.828;3600000;0
2527;3314;101;0;0;0;0;.00nan;0;0
2528;3104;94;0;0;0;0;.00nan;0;0
2528;3228;92;0;0;0;0;.00nan;0;0
2528;3429;92;57;38;4;34;.895;3600000;0
2528;4750;94;56;37;5;32;.865;3575000;0
2529;3111;90;56;24;3;21;.875;3553000;0
2529;3217;90;0;0;0;0;.00nan;0;0
2529;3360;100;94;37;2;35;.946;3600000;0
2529;5260;100;0;0;0;0;.00nan;0;0
2530;3006;103;31;8;3;5;.625;340000;0
2530;3229;101;0;0;0;0;.00nan;0;0
2530;3314;101;40;21;4;17;.810;3600000;0
2530;3440;103;71;33;2;31;.939;3223000;0
2531;3034;104;0;0;0;0;.00nan;0;0
2531;3043;102;0;0;0;0;.00nan;0;0
2531;3272;104;56;25;3;22;.880;3558000;0
2531;3435;102;79;31;2;29;.935;3600000;0
2532;3273;95;54;18;2;16;.889;3600000;0
2532;3316;95;0;0;0;0;.00nan;0;0
2532;3417;89;53;32;4;28;.875;3582000;0
2532;5200;89;0;0;0;0;.00nan;0;0
2533;3228;92;79;26;1;25;.962;3600000;0
2533;3360;100;75;28;3;25;.893;3514000;0
2533;3429;92;0;0;0;0;.00nan;0;0
2533;5260;100;0;0;0;0;.00nan;0;0
2534;3022;88;0;0;0;0;.00nan;0;0
2534;3136;88;83;25;1;24;.960;3600000;0
2534;3141;105;47;23;3;20;.870;3517000;0
2534;4873;105;0;0;0;0;.00nan;0;0
2535;3034;104;0;0;0;0;.00nan;0;0
2535;3272;104;86;30;1;29;.967;3600000;0
2535;3273;95;0;0;0;0;.00nan;0;0
2535;3316;95;50;23;3;20;.870;3518000;0
2536;3193;91;52;16;2;14;.875;3600000;0
2536;3215;91;0;0;0;0;.00nan;0;0
2536;3360;100;64;34;4;30;.882;3576000;0
2536;5260;100;0;0;0;0;.00nan;0;0
2537;2991;96;54;19;3;16;.842;3600000;0
2537;3147;87;72;44;4;40;.909;3600000;0
2537;3246;96;0;0;0;0;.00nan;0;0
2537;3299;87;0;0;0;0;.00nan;0;0
2538;3006;103;69;32;3;29;.906;3600000;0
2538;3228;92;0;0;0;0;.00nan;0;0
2538;3429;92;31;40;7;33;.825;3600000;0
2538;3440;103;0;0;0;0;.00nan;0;0
2539;3104;94;61;21;2;19;.905;3600000;0
2539;3417;89;63;30;3;27;.900;3552000;0
2539;4750;94;0;0;0;0;.00nan;0;0
2539;5200;89;0;0;0;0;.00nan;0;0
2540;3022;88;0;0;0;0;.00nan;0;0
2540;3111;90;0;0;0;0;.00nan;0;0
2540;3136;88;53;32;4;28;.875;3600000;0
2540;3217;90;31;25;5;20;.800;3600000;0
2541;3270;93;0;0;0;0;.00nan;0;0
2541;3394;93;65;32;4;28;.875;3900000;0
2541;3417;89;0;0;0;0;.00nan;0;0
2541;5200;89;74;46;4;42;.913;3900000;0
2542;3228;92;34;41;7;34;.829;3600000;0
2542;3266;86;56;38;6;32;.842;3221000;0
2542;3312;86;55;2;0;2;1.000;379000;0
2542;3429;92;0;0;0;0;.00nan;0;0
2543;3141;105;42;33;5;28;.848;3600000;0
2543;3159;97;48;28;4;24;.857;3600000;0
2543;3323;97;0;0;0;0;.00nan;0;0
2543;4873;105;0;0;0;0;.00nan;0;0
2544;3029;98;0;0;0;0;.00nan;0;0
2544;3104;94;0;0;0;0;.00nan;0;0
2544;3472;98;43;23;4;19;.826;3600000;0
2544;4750;94;44;40;6;34;.850;3578000;0
2545;3034;104;93;40;2;38;.950;3600000;0
2545;3229;101;64;29;3;26;.897;3600000;0
2545;3272;104;0;0;0;0;.00nan;0;0
2545;3314;101;0;0;0;0;.00nan;0;0
2546;3043;102;80;25;1;24;.960;3600000;0
2546;3410;99;84;35;2;33;.943;3577000;0
2546;3435;102;0;0;0;0;.00nan;0;0
2546;5261;99;0;0;0;0;.00nan;0;0
2547;3022;88;94;39;1;38;.974;3600000;0
2547;3111;90;53;32;4;28;.875;3600000;0
2547;3136;88;0;0;0;0;.00nan;0;0
2547;3217;90;0;0;0;0;.00nan;0;0
2548;3006;103;47;7;1;6;.857;968000;0
2548;3273;95;67;27;3;24;.889;3600000;0
2548;3316;95;0;0;0;0;.00nan;0;0
2548;3440;103;46;32;6;26;.813;2632000;0
2549;3043;102;0;0;0;0;.00nan;0;0
2549;3270;93;73;29;2;27;.931;3600000;0
2549;3394;93;0;0;0;0;.00nan;0;0
2549;3435;102;89;53;4;49;.925;3559000;0
2550;3147;87;0;0;0;0;.00nan;0;0
2550;3266;86;64;38;4;34;.895;3600000;0
2550;3299;87;52;37;5;32;.865;3585000;0
2550;3312;86;0;0;0;0;.00nan;0;0
2551;2991;96;62;19;2;17;.895;3600000;0
2551;3229;101;0;0;0;0;.00nan;0;0
2551;3246;96;0;0;0;0;.00nan;0;0
2551;3314;101;51;34;5;29;.853;3600000;0
2552;3029;98;58;22;3;19;.864;3600000;0
2552;3159;97;0;0;0;0;.00nan;0;0
2552;3323;97;65;38;4;34;.895;3549000;0
2552;3472;98;0;0;0;0;.00nan;0;0
2553;3141;105;0;0;0;0;.00nan;0;0
2553;3360;100;0;0;0;0;.00nan;0;0
2553;4873;105;46;41;6;35;.854;3589000;0
2553;5260;100;50;27;4;23;.852;3600000;0
2554;3193;91;0;0;0;0;.00nan;0;0
2554;3215;91;93;22;0;22;1.000;3600000;0
2554;3417;89;72;41;4;37;.902;3600000;0
2554;5200;89;0;0;0;0;.00nan;0;0
2555;2991;96;0;0;0;0;.00nan;0;0
2555;3246;96;64;22;2;20;.909;3600000;0
2555;3410;99;67;32;3;29;.906;3600000;0
2555;5261;99;0;0;0;0;.00nan;0;0
2556;3029;98;0;0;0;0;.00nan;0;0
2556;3159;97;57;23;3;20;.870;3600000;0
2556;3323;97;0;0;0;0;.00nan;0;0
2556;3472;98;53;36;5;31;.861;3560000;0
2557;3228;92;0;0;0;0;.00nan;0;0
2557;3273;95;48;0;0;0;.00nan;401000;0
2557;3316;95;20;26;6;20;.769;3193000;0
2557;3429;92;43;28;5;23;.821;3600000;0
2558;3104;94;69;24;2;22;.917;3600000;0
2558;3147;87;81;43;3;40;.930;3600000;0
2558;3299;87;0;0;0;0;.00nan;0;0
2558;4750;94;0;0;0;0;.00nan;0;0
2559;3006;103;45;30;5;25;.833;3600000;0
2559;3034;104;0;0;0;0;.00nan;0;0
2559;3272;104;84;29;2;27;.931;3600000;0
2559;3440;103;0;0;0;0;.00nan;0;0
2560;3022;88;0;0;0;0;.00nan;0;0
2560;3043;102;66;39;4;35;.897;3900000;0
2560;3136;88;71;31;4;27;.871;3900000;0
2560;3435;102;0;0;0;0;.00nan;0;0
2561;3006;103;60;42;5;37;.881;3325000;0
2561;3229;101;52;29;4;25;.862;3600000;0
2561;3314;101;0;0;0;0;.00nan;0;0
2561;3440;103;32;4;2;2;.500;275000;0
2562;3034;104;60;40;5;35;.875;3608000;0
2562;3043;102;51;27;4;23;.852;3608000;0
2562;3272;104;0;0;0;0;.00nan;0;0
2562;3435;102;0;0;0;0;.00nan;0;0
2563;2991;96;83;38;2;36;.947;3900000;0
2563;3193;91;0;0;0;0;.00nan;0;0
2563;3215;91;87;37;2;35;.946;3900000;0
2563;3246;96;0;0;0;0;.00nan;0;0
2564;3228;92;0;0;0;0;.00nan;0;0
2564;3417;89;52;35;5;30;.857;3600000;0
2564;3429;92;97;35;2;33;.943;3600000;0
2564;5200;89;0;0;0;0;.00nan;0;0
2565;3022;88;0;0;0;0;.00nan;0;0
2565;3104;94;64;12;1;11;.917;3600000;0
2565;3136;88;77;37;2;35;.946;3580000;0
2565;4750;94;0;0;0;0;.00nan;0;0
2566;3111;90;53;2;0;2;1.000;433000;0
2566;3147;87;20;9;4;5;.556;1193000;0
2566;3217;90;19;27;7;20;.741;3126000;0
2566;3299;87;51;17;2;15;.882;2407000;0
2567;3141;105;0;0;0;0;.00nan;0;0
2567;3360;100;28;40;8;32;.800;3600000;0
2567;4873;105;78;25;1;24;.960;3600000;0
2567;5260;100;0;0;0;0;.00nan;0;0
2568;3193;91;46;44;7;37;.841;3600000;0
2568;3215;91;0;0;0;0;.00nan;0;0
2568;3270;93;0;0;0;0;.00nan;0;0
2568;3394;93;58;27;3;24;.889;3600000;0
2569;3266;86;73;29;3;26;.897;3900000;0
2569;3312;86;0;0;0;0;.00nan;0;0
2569;3410;99;63;33;3;30;.909;3900000;0
2569;5261;99;0;0;0;0;.00nan;0;0
2570;2991;96;0;0;0;0;.00nan;0;0
2570;3029;98;43;28;5;23;.821;3596000;0
2570;3246;96;32;19;4;15;.789;3600000;0
2570;3472;98;0;0;0;0;.00nan;0;0
2571;3159;97;56;40;6;34;.850;3124000;0
2571;3229;101;42;27;5;22;.815;3600000;0
2571;3314;101;0;0;0;0;.00nan;0;0
2571;3323;97;54;4;0;4;1.000;435000;0
2572;3228;92;76;22;2;20;.909;3600000;0
2572;3273;95;0;0;0;0;.00nan;0;0
2572;3316;95;64;36;4;32;.889;3567000;0
2572;3429;92;0;0;0;0;.00nan;0;0
2573;3006;103;83;28;1;27;.964;3600000;0
2573;3104;94;0;0;0;0;.00nan;0;0
2573;3440;103;0;0;0;0;.00nan;0;0
2573;4750;94;67;23;2;21;.913;3579000;0
2574;3022;88;66;28;3;25;.893;3677000;0
2574;3136;88;0;0;0;0;.00nan;0;0
2574;3147;87;73;43;4;39;.907;3677000;0
2574;3299;87;0;0;0;0;.00nan;0;0
2575;3034;104;0;0;0;0;.00nan;0;0
2575;3272;104;74;30;2;28;.933;3600000;0
2575;3417;89;31;27;6;21;.778;2062000;0
2575;5200;89;18;22;6;16;.727;1538000;0
2576;3159;97;0;0;0;0;.00nan;0;0
2576;3193;91;0;0;0;0;.00nan;0;0
2576;3215;91;36;20;4;16;.800;3517000;0
2576;3323;97;100;38;2;36;.947;3600000;0
2577;3111;90;0;0;0;0;.00nan;0;0
2577;3217;90;51;27;4;23;.852;3600000;0
2577;3266;86;0;0;0;0;.00nan;0;0
2577;3312;86;62;36;5;31;.861;3561000;0
2578;2991;96;63;24;2;22;.917;3600000;0
2578;3029;98;0;0;0;0;.00nan;0;0
2578;3246;96;0;0;0;0;.00nan;0;0
2578;3472;98;82;50;4;46;.920;3569000;0
2579;3229;101;0;0;0;0;.00nan;0;0
2579;3314;101;54;28;4;24;.857;3600000;0
2579;3360;100;87;33;1;32;.970;2445000;0
2579;5260;100;48;22;4;18;.818;1130000;0
2580;3043;102;31;31;6;25;.806;3600000;0
2580;3410;99;35;28;5;23;.821;2448000;0
2580;3435;102;0;0;0;0;.00nan;0;0
2580;5261;99;31;11;4;7;.636;1152000;0
2581;3104;94;77;33;2;31;.939;3600000;0
2581;3141;105;52;29;4;25;.862;3582000;0
2581;4750;94;0;0;0;0;.00nan;0;0
2581;4873;105;0;0;0;0;.00nan;0;0
2582;3159;97;78;51;4;47;.922;3555000;0
2582;3270;93;69;25;2;23;.920;3600000;0
2582;3323;97;0;0;0;0;.00nan;0;0
2582;3394;93;0;0;0;0;.00nan;0;0
2583;3006;103;74;33;2;31;.939;3600000;0
2583;3410;99;58;5;0;5;1.000;1209000;0
2583;3440;103;0;0;0;0;.00nan;0;0
2583;5261;99;30;19;5;14;.737;2391000;0
2584;3147;87;22;16;5;11;.688;2625000;0
2584;3228;92;0;0;0;0;.00nan;0;0
2584;3299;87;12;11;5;6;.545;975000;0
2584;3429;92;72;27;2;25;.926;3600000;0
2585;3043;102;0;0;0;0;.00nan;0;0
2585;3360;100;0;0;0;0;.00nan;0;0
2585;3435;102;82;38;3;35;.921;3600000;0
2585;5260;100;31;32;6;26;.813;3582000;0
2586;3022;88;0;0;0;0;.00nan;0;0
2586;3111;90;36;24;5;19;.792;3608000;0
2586;3136;88;70;35;4;31;.886;3608000;0
2586;3217;90;0;0;0;0;.00nan;0;0
2587;3273;95;66;23;3;20;.870;3535000;0
2587;3316;95;0;0;0;0;.00nan;0;0
2587;3417;89;73;21;1;20;.952;3600000;0
2587;5200;89;0;0;0;0;.00nan;0;0
2588;3006;103;0;0;0;0;.00nan;0;0
2588;3029;98;0;0;0;0;.00nan;0;0
2588;3440;103;47;31;5;26;.839;3600000;0
2588;3472;98;62;22;2;20;.909;3600000;0
2589;3104;94;61;26;3;23;.885;3600000;0
2589;3111;90;48;0;0;0;.00nan;267000;0
2589;3217;90;27;24;5;19;.792;3300000;0
2589;4750;94;0;0;0;0;.00nan;0;0
2590;3034;104;71;44;4;40;.909;3600000;0
2590;3141;105;0;0;0;0;.00nan;0;0
2590;3272;104;0;0;0;0;.00nan;0;0
2590;4873;105;68;30;3;27;.900;3600000;0
2591;3104;94;86;29;1;28;.966;3600000;0
2591;3193;91;60;27;2;25;.926;3557000;0
2591;3215;91;0;0;0;0;.00nan;0;0
2591;4750;94;0;0;0;0;.00nan;0;0
2592;3228;92;0;0;0;0;.00nan;0;0
2592;3270;93;0;0;0;0;.00nan;0;0
2592;3394;93;82;26;1;25;.962;3600000;0
2592;3429;92;75;32;2;30;.938;3571000;0
2593;2991;96;97;24;0;24;1.000;3600000;0
2593;3246;96;0;0;0;0;.00nan;0;0
2593;3266;86;66;37;4;33;.892;3600000;0
2593;3312;86;0;0;0;0;.00nan;0;0
2594;3159;97;47;24;4;20;.833;3683000;0
2594;3323;97;0;0;0;0;.00nan;0;0
2594;3417;89;51;22;3;19;.864;3683000;0
2594;5200;89;0;0;0;0;.00nan;0;0
2595;3029;98;100;33;0;33;1.000;3900000;0
2595;3273;95;0;0;0;0;.00nan;0;0
2595;3316;95;89;38;0;38;1.000;3900000;0
2595;3472;98;0;0;0;0;.00nan;0;0
2596;3141;105;89;44;3;41;.932;3589000;0
2596;3229;101;66;21;2;19;.905;3600000;0
2596;3314;101;0;0;0;0;.00nan;0;0
2596;4873;105;0;0;0;0;.00nan;0;0
2597;3034;104;0;0;0;0;.00nan;0;0
2597;3272;104;27;27;6;21;.778;3600000;0
2597;3410;99;18;8;4;4;.500;975000;0
2597;5261;99;38;24;4;20;.833;2562000;0
2598;3111;90;0;0;0;0;.00nan;0;0
2598;3147;87;85;36;2;34;.944;3562000;0
2598;3217;90;73;25;1;24;.960;3600000;0
2598;3299;87;0;0;0;0;.00nan;0;0
2599;3006;103;91;44;3;41;.932;3900000;0
2599;3022;88;0;0;0;0;.00nan;0;0
2599;3136;88;80;33;3;30;.909;3900000;0
2599;3440;103;0;0;0;0;.00nan;0;0
2600;2991;96;69;31;3;28;.903;3553000;0
2600;3193;91;0;0;0;0;.00nan;0;0
2600;3215;91;77;23;1;22;.957;3600000;0
2600;3246;96;0;0;0;0;.00nan;0;0
2601;3006;103;0;0;0;0;.00nan;0;0
2601;3270;93;13;18;6;12;.667;3075000;0
2601;3394;93;48;7;1;6;.857;525000;0
2601;3440;103;56;33;4;29;.879;3600000;0
2602;3266;86;48;37;6;31;.838;3600000;0
2602;3273;95;0;0;0;0;.00nan;0;0
2602;3312;86;0;0;0;0;.00nan;0;0
2602;3316;95;23;30;7;23;.767;3543000;0
2603;3147;87;0;0;0;0;.00nan;0;0
2603;3159;97;0;0;0;0;.00nan;0;0
2603;3299;87;57;35;5;30;.857;3766000;0
2603;3323;97;55;26;4;22;.846;3766000;0
2604;3034;104;82;29;1;28;.966;3600000;0
2604;3229;101;0;0;0;0;.00nan;0;0
2604;3272;104;0;0;0;0;.00nan;0;0
2604;3314;101;56;20;4;16;.800;3600000;0
2605;3043;102;61;31;4;27;.871;3534000;0
2605;3360;100;0;0;0;0;.00nan;0;0
2605;3435;102;0;0;0;0;.00nan;0;0
2605;5260;100;69;26;2;24;.923;3600000;0
2606;3228;92;73;29;2;27;.931;3600000;0
2606;3270;93;0;0;0;0;.00nan;0;0
2606;3394;93;43;33;5;28;.848;3600000;0
2606;3429;92;0;0;0;0;.00nan;0;0
2607;3022;88;0;0;0;0;.00nan;0;0
2607;3136;88;71;33;3;30;.909;3600000;0
2607;3266;86;63;33;4;29;.879;3600000;0
2607;3312;86;0;0;0;0;.00nan;0;0
2608;3029;98;53;15;2;13;.867;3600000;0
2608;3043;102;0;0;0;0;.00nan;0;0
2608;3435;102;42;38;6;32;.842;3600000;0
2608;3472;98;0;0;0;0;.00nan;0;0
2609;3141;105;72;42;4;38;.905;3600000;0
2609;3229;101;24;28;7;21;.750;3600000;0
2609;3314;101;0;0;0;0;.00nan;0;0
2609;4873;105;0;0;0;0;.00nan;0;0
2610;3360;100;74;34;2;32;.941;3585000;0
2610;3410;99;72;20;1;19;.950;3600000;0
2610;5260;100;0;0;0;0;.00nan;0;0
2610;5261;99;0;0;0;0;.00nan;0;0
2611;3104;94;67;13;1;12;.923;3600000;0
2611;3273;95;56;45;7;38;.844;3600000;0
2611;3316;95;0;0;0;0;.00nan;0;0
2611;4750;94;0;0;0;0;.00nan;0;0
2612;3147;87;81;52;5;47;.904;3600000;0
2612;3299;87;0;0;0;0;.00nan;0;0
2612;3417;89;91;20;0;20;1.000;3600000;0
2612;5200;89;0;0;0;0;.00nan;0;0
2613;3022;88;58;34;4;30;.882;3600000;0
2613;3111;90;30;31;6;25;.806;3554000;0
2613;3136;88;0;0;0;0;.00nan;0;0
2613;3217;90;0;0;0;0;.00nan;0;0
2614;3159;97;29;35;7;28;.800;3600000;0
2614;3266;86;55;20;3;17;.850;3600000;0
2614;3312;86;0;0;0;0;.00nan;0;0
2614;3323;97;0;0;0;0;.00nan;0;0
2615;3034;104;0;0;0;0;.00nan;0;0
2615;3272;104;60;20;2;18;.900;3600000;0
2615;3410;99;59;37;4;33;.892;3533000;0
2615;5261;99;0;0;0;0;.00nan;0;0
2616;3147;87;86;43;3;40;.930;3600000;0
2616;3299;87;0;0;0;0;.00nan;0;0
2616;3417;89;38;22;5;17;.773;3516000;0
2616;5200;89;0;0;0;0;.00nan;0;0
2617;3006;103;28;7;3;4;.571;586000;0
2617;3360;100;67;12;0;12;1.000;1008000;0
2617;3440;103;67;19;1;18;.947;3014000;0
2617;5260;100;33;33;6;27;.818;2528000;0
2618;2991;96;63;26;3;23;.885;3600000;0
2618;3104;94;38;25;4;21;.840;3566000;0
2618;3246;96;0;0;0;0;.00nan;0;0
2618;4750;94;0;0;0;0;.00nan;0;0
2619;3141;105;0;0;0;0;.00nan;0;0
2619;3228;92;0;0;0;0;.00nan;0;0
2619;3429;92;56;40;5;35;.875;3600000;0
2619;4873;105;63;25;2;23;.920;3600000;0
2620;3043;102;83;47;3;44;.936;3900000;0
2620;3111;90;0;0;0;0;.00nan;0;0
2620;3217;90;58;27;3;24;.889;3900000;0
2620;3435;102;0;0;0;0;.00nan;0;0
2621;3193;91;53;4;0;4;1.000;1641000;0
2621;3215;91;25;20;5;15;.750;1898000;0
2621;3273;95;62;30;3;27;.900;3600000;0
2621;3316;95;0;0;0;0;.00nan;0;0
2622;3270;93;77;35;3;32;.914;3577000;0
2622;3394;93;0;0;0;0;.00nan;0;0
2622;3417;89;87;34;2;32;.941;3600000;0
2622;5200;89;0;0;0;0;.00nan;0;0
2623;2991;96;0;0;0;0;.00nan;0;0
2623;3159;97;0;0;0;0;.00nan;0;0
2623;3246;96;73;28;2;26;.929;3600000;0
2623;3323;97;64;41;4;37;.902;3556000;0
2624;3029;98;60;28;4;24;.857;3600000;0
2624;3034;104;0;0;0;0;.00nan;0;0
2624;3272;104;49;28;5;23;.821;3544000;0
2624;3472;98;0;0;0;0;.00nan;0;0
2625;3111;90;57;47;6;41;.872;3600000;0
2625;3217;90;0;0;0;0;.00nan;0;0
2625;3229;101;55;27;3;24;.889;3600000;0
2625;3314;101;0;0;0;0;.00nan;0;0
2626;3228;92;80;41;3;38;.927;3514000;0
2626;3410;99;78;22;1;21;.955;3600000;0
2626;3429;92;0;0;0;0;.00nan;0;0
2626;5261;99;0;0;0;0;.00nan;0;0
2627;3006;103;62;33;4;29;.879;3600000;0
2627;3104;94;0;0;0;0;.00nan;0;0
2627;3440;103;0;0;0;0;.00nan;0;0
2627;4750;94;95;23;0;23;1.000;3600000;0
2628;3022;88;0;0;0;0;.00nan;0;0
2628;3136;88;91;28;2;26;.929;3600000;0
2628;3147;87;33;38;7;31;.816;3204000;0
2628;3299;87;54;5;0;5;1.000;396000;0
2629;3193;91;73;17;1;16;.941;3600000;0
2629;3215;91;0;0;0;0;.00nan;0;0
2629;3273;95;0;0;0;0;.00nan;0;0
2629;3316;95;62;40;4;36;.900;3600000;0
2630;3147;87;77;39;4;35;.897;3279000;0
2630;3270;93;0;0;0;0;.00nan;0;0
2630;3299;87;41;14;3;11;.786;321000;0
2630;3394;93;75;20;1;19;.950;3600000;0
2631;3104;94;0;0;0;0;.00nan;0;0
2631;3266;86;0;0;0;0;.00nan;0;0
2631;3312;86;54;34;5;29;.853;3574000;0
2631;4750;94;63;27;3;24;.889;3600000;0
2632;2991;96;71;32;4;28;.875;3537000;0
2632;3006;103;0;0;0;0;.00nan;0;0
2632;3246;96;0;0;0;0;.00nan;0;0
2632;3440;103;85;26;2;24;.923;3600000;0
2633;3029;98;0;0;0;0;.00nan;0;0
2633;3360;100;72;20;1;19;.950;3600000;0
2633;3472;98;62;31;3;28;.903;3575000;0
2633;5260;100;0;0;0;0;.00nan;0;0
2634;3034;104;100;37;0;37;1.000;3600000;0
2634;3229;101;57;13;1;12;.923;1786000;0
2634;3272;104;0;0;0;0;.00nan;0;0
2634;3314;101;31;20;5;15;.750;1814000;0
2635;3043;102;77;34;3;31;.912;3600000;0
2635;3141;105;23;24;6;18;.750;2591000;0
2635;3435;102;0;0;0;0;.00nan;0;0
2635;4873;105;41;9;2;7;.778;1009000;0
2636;3266;86;33;32;6;26;.813;3600000;0
2636;3270;93;83;29;1;28;.966;3600000;0
2636;3312;86;0;0;0;0;.00nan;0;0
2636;3394;93;0;0;0;0;.00nan;0;0
2637;3159;97;9;18;6;12;.667;1926000;0
2637;3323;97;55;13;1;12;.923;1674000;0
2637;3410;99;60;40;4;36;.900;3600000;0
2637;5261;99;0;0;0;0;.00nan;0;0
2638;3022;88;0;0;0;0;.00nan;0;0
2638;3029;98;76;28;2;26;.929;3600000;0
2638;3136;88;63;14;1;13;.929;3600000;0
2638;3472;98;0;0;0;0;.00nan;0;0
2639;3043;102;50;1;0;1;1.000;233000;0
2639;3229;101;57;30;4;26;.867;3600000;0
2639;3314;101;0;0;0;0;.00nan;0;0
2639;3435;102;44;38;6;32;.842;3288000;0
2640;3273;95;41;38;6;32;.842;3600000;0
2640;3316;95;0;0;0;0;.00nan;0;0
2640;3360;100;0;0;0;0;.00nan;0;0
2640;5260;100;64;18;1;17;.944;3600000;0
2641;3111;90;0;0;0;0;.00nan;0;0
2641;3141;105;0;0;0;0;.00nan;0;0
2641;3217;90;80;40;3;37;.925;3527000;0
2641;4873;105;93;39;1;38;.974;3600000;0
2642;3193;91;45;28;4;24;.857;3900000;0
2642;3215;91;0;0;0;0;.00nan;0;0
2642;3266;86;65;43;4;39;.907;3900000;0
2642;3312;86;0;0;0;0;.00nan;0;0
2643;2991;96;34;19;4;15;.789;3550000;0
2643;3034;104;74;30;2;28;.933;3600000;0
2643;3246;96;0;0;0;0;.00nan;0;0
2643;3272;104;0;0;0;0;.00nan;0;0
2644;3043;102;52;36;6;30;.833;3600000;0
2644;3229;101;21;3;3;0;.000;153000;0
2644;3314;101;49;40;6;34;.850;3447000;0
2644;3435;102;0;0;0;0;.00nan;0;0
2645;3147;87;39;39;7;32;.821;3600000;0
2645;3299;87;0;0;0;0;.00nan;0;0
2645;3417;89;83;35;2;33;.943;3600000;0
2645;5200;89;0;0;0;0;.00nan;0;0
2646;3141;105;48;35;6;29;.829;3600000;0
2646;3228;92;0;0;0;0;.00nan;0;0
2646;3429;92;80;27;1;26;.963;3600000;0
2646;4873;105;0;0;0;0;.00nan;0;0
2647;3111;90;0;0;0;0;.00nan;0;0
2647;3217;90;66;17;1;16;.941;3600000;0
2647;3360;100;64;35;3;32;.914;3531000;0
2647;5260;100;0;0;0;0;.00nan;0;0
2648;3193;91;0;0;0;0;.00nan;0;0
2648;3215;91;49;43;5;38;.884;3600000;0
2648;3270;93;0;0;0;0;.00nan;0;0
2648;3394;93;55;28;4;24;.857;3600000;0
2649;2991;96;75;28;2;26;.929;3579000;0
2649;3043;102;93;29;1;28;.966;3600000;0
2649;3246;96;0;0;0;0;.00nan;0;0
2649;3435;102;0;0;0;0;.00nan;0;0
2650;3104;94;47;30;4;26;.867;3600000;0
2650;3159;97;0;0;0;0;.00nan;0;0
2650;3323;97;79;31;2;29;.935;3600000;0
2650;4750;94;0;0;0;0;.00nan;0;0
2651;3029;98;100;44;1;43;.977;3600000;0
2651;3111;90;49;30;4;26;.867;3600000;0
2651;3217;90;0;0;0;0;.00nan;0;0
2651;3472;98;0;0;0;0;.00nan;0;0
2652;3034;104;62;34;4;30;.882;3600000;0
2652;3229;101;21;26;6;20;.769;3552000;0
2652;3272;104;0;0;0;0;.00nan;0;0
2652;3314;101;0;0;0;0;.00nan;0;0
2653;3006;103;77;41;4;37;.902;3547000;0
2653;3410;99;67;29;3;26;.897;3600000;0
2653;3440;103;0;0;0;0;.00nan;0;0
2653;5261;99;0;0;0;0;.00nan;0;0
2654;3147;87;49;28;4;24;.857;3600000;0
2654;3299;87;0;0;0;0;.00nan;0;0
2654;3360;100;56;11;1;10;.909;1417000;0
2654;5260;100;21;24;6;18;.750;2183000;0
2655;3022;88;0;0;0;0;.00nan;0;0
2655;3136;88;70;43;5;38;.884;3600000;0
2655;3417;89;76;33;3;30;.909;3600000;0
2655;5200;89;0;0;0;0;.00nan;0;0
2656;3141;105;0;0;0;0;.00nan;0;0
2656;3273;95;25;28;6;22;.786;3599000;0
2656;3316;95;0;0;0;0;.00nan;0;0
2656;4873;105;63;35;4;31;.886;3600000;0
2657;3022;88;0;0;0;0;.00nan;0;0
2657;3136;88;92;30;1;29;.967;3600000;0
2657;3193;91;47;23;4;19;.826;3600000;0
2657;3215;91;0;0;0;0;.00nan;0;0
2658;3266;86;57;17;2;15;.882;3600000;0
2658;3270;93;65;37;4;33;.892;3583000;0
2658;3312;86;0;0;0;0;.00nan;0;0
2658;3394;93;0;0;0;0;.00nan;0;0
2659;2991;96;0;0;0;0;.00nan;0;0
2659;3229;101;0;0;0;0;.00nan;0;0
2659;3246;96;58;31;4;27;.871;3514000;0
2659;3314;101;74;29;2;27;.931;3600000;0
2660;3159;97;52;29;4;25;.862;3600000;0
2660;3323;97;0;0;0;0;.00nan;0;0
2660;3410;99;0;0;0;0;.00nan;0;0
2660;5261;99;37;30;6;24;.800;3600000;0
2661;3006;103;52;10;1;9;.900;1565000;0
2661;3043;102;0;0;0;0;.00nan;0;0
2661;3435;102;73;33;3;30;.909;3600000;0
2661;3440;103;20;21;6;15;.714;2035000;0
2662;3104;94;83;30;2;28;.933;3600000;0
2662;3266;86;33;33;6;27;.818;2883000;0
2662;3312;86;47;6;1;5;.833;717000;0
2662;4750;94;0;0;0;0;.00nan;0;0
2663;3006;103;31;31;6;25;.806;3291000;0
2663;3029;98;57;33;4;29;.879;3600000;0
2663;3440;103;50;1;0;1;1.000;265000;0
2663;3472;98;0;0;0;0;.00nan;0;0
2664;3228;92;0;0;0;0;.00nan;0;0
2664;3273;95;0;0;0;0;.00nan;0;0
2664;3316;95;54;29;4;25;.862;3600000;0
2664;3429;92;78;31;2;29;.935;3600000;0
2665;3022;88;89;35;2;33;.943;3600000;0
2665;3136;88;0;0;0;0;.00nan;0;0
2665;3147;87;53;3;0;3;1.000;539000;0
2665;3299;87;33;30;6;24;.800;3061000;0
2666;3360;100;67;30;2;28;.933;3600000;0
2666;3417;89;55;23;3;20;.870;3545000;0
2666;5200;89;0;0;0;0;.00nan;0;0
2666;5260;100;0;0;0;0;.00nan;0;0
2667;3034;104;0;0;0;0;.00nan;0;0
2667;3141;105;47;34;5;29;.853;3900000;0
2667;3272;104;43;30;5;25;.833;3900000;0
2667;4873;105;0;0;0;0;.00nan;0;0
4761;2991;96;62;37;5;32;.865;3600000;0
4761;3193;96;0;0;0;0;.00nan;0;0
4761;3273;95;0;0;0;0;.00nan;0;0
4761;3316;95;65;14;1;13;.929;3600000;0
4763;3006;103;96;43;3;40;.930;3600000;0
4763;3034;104;0;0;0;0;.00nan;0;0
4763;3120;103;0;0;0;0;.00nan;0;0
4763;3272;104;67;34;4;30;.882;3575000;0
4765;3147;87;39;25;5;20;.800;3600000;0
4765;3228;92;0;0;0;0;.00nan;0;0
4765;3299;87;0;0;0;0;.00nan;0;0
4765;3429;92;90;34;2;32;.941;3600000;0
4767;2987;88;0;0;0;0;.00nan;0;0
4767;3022;88;79;30;2;28;.933;3900000;0
4767;3360;100;100;35;2;33;.943;3900000;0
4767;5260;100;0;0;0;0;.00nan;0;0
4769;3141;105;83;36;3;33;.917;3600000;0
4769;3159;97;19;20;6;14;.700;1438900;0
4769;3323;97;66;16;1;15;.938;2161100;0
4769;4873;105;0;0;0;0;.00nan;0;0
4771;3111;90;48;0;0;0;.00nan;319700;0
4771;3217;90;42;32;6;26;.813;3280300;0
4771;3270;93;100;44;1;43;.977;3600000;0
4771;3394;93;0;0;0;0;.00nan;0;0
4773;3043;102;47;35;6;29;.829;3600000;0
4773;3417;89;0;0;0;0;.00nan;0;0
4773;3435;102;0;0;0;0;.00nan;0;0
4773;5200;89;82;35;3;32;.914;3600000;0
4775;3136;101;54;32;5;27;.844;3600000;0
4775;3215;101;0;0;0;0;.00nan;0;0
4775;3410;99;96;32;1;31;.969;3600000;0
4775;5261;99;0;0;0;0;.00nan;0;0
4777;3029;98;0;0;0;0;.00nan;0;0
4777;3104;94;0;0;0;0;.00nan;0;0
4777;3472;98;45;20;4;16;.800;3773300;0
4777;4750;94;90;41;3;38;.927;3773300;0
4779;3233;91;0;0;0;0;.00nan;0;0
4779;3246;86;0;0;0;0;.00nan;0;0
4779;3266;86;72;30;3;27;.900;3582100;0
4779;5262;91;84;31;2;29;.935;3600000;0
4781;3111;90;0;0;0;0;.00nan;0;0
4781;3147;87;0;0;0;0;.00nan;0;0
4781;3217;90;46;35;6;29;.829;3600000;0
4781;3299;87;72;22;2;20;.909;3600000;0
4783;3141;105;0;0;0;0;.00nan;0;0
4783;3159;97;63;14;1;13;.929;1754350;0
4783;3323;97;7;19;7;12;.632;1845650;0
4783;4873;105;62;35;5;30;.857;3600000;0
4785;3006;103;55;34;5;29;.853;3581100;0
4785;3233;91;87;36;3;33;.917;3600000;0
4785;3440;103;0;0;0;0;.00nan;0;0
4785;5262;91;0;0;0;0;.00nan;0;0
4787;3043;102;77;35;3;32;.914;3900000;0
4787;3136;101;0;0;0;0;.00nan;0;0
4787;3215;101;87;35;3;32;.914;3900000;0
4787;3435;102;0;0;0;0;.00nan;0;0
4789;3034;104;0;0;0;0;.00nan;0;0
4789;3272;104;40;24;5;19;.792;3600000;0
4789;3410;99;46;35;6;29;.829;3573000;0
4789;5261;99;0;0;0;0;.00nan;0;0
4791;3104;94;88;33;2;31;.939;3600000;0
4791;3417;89;84;38;3;35;.921;3544150;0
4791;4750;94;0;0;0;0;.00nan;0;0
4791;5200;89;0;0;0;0;.00nan;0;0
4793;2987;88;0;0;0;0;.00nan;0;0
4793;3022;88;39;25;5;20;.800;3600000;0
4793;3228;92;75;25;2;23;.920;3600000;0
4793;3429;92;0;0;0;0;.00nan;0;0
4795;3029;98;74;24;2;22;.917;3600000;0
4795;3360;100;40;5;2;3;.600;1354450;0
4795;3472;98;0;0;0;0;.00nan;0;0
4795;5260;100;23;22;6;16;.727;2245550;0
4797;2991;96;0;0;0;0;.00nan;0;0
4797;3193;96;81;34;3;31;.912;3600000;0
4797;3270;93;61;31;4;27;.871;3559150;0
4797;3394;93;0;0;0;0;.00nan;0;0
4799;3246;86;0;0;0;0;.00nan;0;0
4799;3266;86;65;42;6;36;.857;3592800;0
4799;3273;95;52;31;5;26;.839;3610550;0
4799;3316;95;0;0;0;0;.00nan;0;0
4801;3159;97;0;0;0;0;.00nan;0;0
4801;3323;97;47;35;6;29;.829;3600000;0
4801;3360;100;100;33;1;32;.970;3600000;0
4801;5260;100;0;0;0;0;.00nan;0;0
4803;3233;91;0;0;0;0;.00nan;0;0
4803;3246;86;97;36;2;34;.944;3600000;0
4803;3266;86;0;0;0;0;.00nan;0;0
4803;5262;91;71;37;4;33;.892;3557550;0
4805;3043;102;0;0;0;0;.00nan;0;0
4805;3141;105;65;27;3;24;.889;3600000;0
4805;3435;102;97;38;2;36;.947;3600000;0
4805;4873;105;0;0;0;0;.00nan;0;0
4807;2991;96;25;17;5;12;.706;2105150;0
4807;3193;96;39;19;4;15;.789;1494850;0
4807;3228;92;0;0;0;0;.00nan;0;0
4807;3429;92;67;15;1;14;.933;3600000;0
4809;3104;94;0;0;0;0;.00nan;0;0
4809;3410;99;0;0;0;0;.00nan;0;0
4809;4750;94;48;23;4;19;.826;3524350;0
4809;5261;99;88;40;3;37;.925;3600000;0
4811;3147;87;23;10;4;6;.600;826850;0
4811;3270;93;0;0;0;0;.00nan;0;0
4811;3299;87;52;26;4;22;.846;2773150;0
4811;3394;93;71;29;3;26;.897;3600000;0
4813;2987;88;80;47;5;42;.894;3765850;0
4813;3022;88;0;0;0;0;.00nan;0;0
4813;3111;90;64;32;4;28;.875;3769750;0
4813;3217;90;0;0;0;0;.00nan;0;0
4815;3029;98;0;0;0;0;.00nan;0;0
4815;3034;104;90;39;3;36;.923;3600000;0
4815;3272;104;0;0;0;0;.00nan;0;0
4815;3472;98;71;36;4;32;.889;3541250;0
4817;3273;95;0;0;0;0;.00nan;0;0
4817;3316;95;100;40;1;39;.975;3900000;0
4817;3417;89;0;0;0;0;.00nan;0;0
4817;5200;89;90;27;1;26;.963;3900000;0
4819;3006;103;0;0;0;0;.00nan;0;0
4819;3136;101;69;27;3;24;.889;3880900;0
4819;3215;101;0;0;0;0;.00nan;0;0
4819;3440;103;69;35;4;31;.886;3880900;0
4821;2991;96;59;28;4;24;.857;3600000;0
4821;3193;96;0;0;0;0;.00nan;0;0
4821;3233;91;71;23;2;21;.913;3600000;0
4821;5262;91;0;0;0;0;.00nan;0;0
4823;3034;104;0;0;0;0;.00nan;0;0
4823;3272;104;83;37;3;34;.919;3598300;0
4823;3417;89;0;0;0;0;.00nan;0;0
4823;5200;89;78;27;2;25;.926;3600000;0
4825;3104;94;90;25;1;24;.960;3600000;0
4825;3111;90;53;3;0;3;1.000;311250;0
4825;3217;90;34;28;6;22;.786;3288750;0
4825;4750;94;0;0;0;0;.00nan;0;0
4827;3141;105;0;0;0;0;.00nan;0;0
4827;3246;86;0;0;0;0;.00nan;0;0
4827;3266;86;88;31;2;29;.935;3600000;0
4827;4873;105;72;35;4;31;.886;3600000;0
4829;2987;88;0;0;0;0;.00nan;0;0
4829;3022;88;79;41;4;37;.902;3578800;0
4829;3360;100;0;0;0;0;.00nan;0;0
4829;5260;100;78;33;3;30;.909;3600000;0
4831;3006;103;64;26;3;23;.885;3600000;0
4831;3159;97;68;46;6;40;.870;3597600;0
4831;3323;97;0;0;0;0;.00nan;0;0
4831;3440;103;0;0;0;0;.00nan;0;0
4833;3147;87;100;27;0;27;1.000;3600000;0
4833;3273;95;72;31;3;28;.903;3600000;0
4833;3299;87;0;0;0;0;.00nan;0;0
4833;3316;95;0;0;0;0;.00nan;0;0
4835;3043;102;73;18;1;17;.944;3600000;0
4835;3270;93;43;33;6;27;.818;3600000;0
4835;3394;93;0;0;0;0;.00nan;0;0
4835;3435;102;0;0;0;0;.00nan;0;0
4837;3029;98;0;0;0;0;.00nan;0;0
4837;3228;92;85;35;3;32;.914;3900000;0
4837;3429;92;0;0;0;0;.00nan;0;0
4837;3472;98;97;46;3;43;.935;3900000;0
4839;3136;101;30;31;7;24;.774;3600000;0
4839;3215;101;0;0;0;0;.00nan;0;0
4839;3410;99;75;33;4;29;.879;3600000;0
4839;5261;99;0;0;0;0;.00nan;0;0
4841;3034;104;25;29;7;22;.759;3600000;0
4841;3111;90;86;38;3;35;.921;3600000;0
4841;3217;90;0;0;0;0;.00nan;0;0
4841;3272;104;0;0;0;0;.00nan;0;0
4843;3104;94;0;0;0;0;.00nan;0;0
4843;3273;95;0;0;0;0;.00nan;0;0
4843;3316;95;84;33;2;31;.939;3900000;0
4843;4750;94;99;36;2;34;.944;3900000;0
4845;3043;102;0;0;0;0;.00nan;0;0
4845;3159;97;0;0;0;0;.00nan;0;0
4845;3323;97;71;36;4;32;.889;3900000;0
4845;3435;102;77;40;4;36;.900;3900000;0
4847;3147;87;38;30;6;24;.800;3600000;0
4847;3233;91;0;0;0;0;.00nan;0;0
4847;3299;87;0;0;0;0;.00nan;0;0
4847;5262;91;71;26;3;23;.885;3600000;0
4849;3410;99;0;0;0;0;.00nan;0;0
4849;3417;89;100;47;2;45;.957;3600000;0
4849;5200;89;0;0;0;0;.00nan;0;0
4849;5261;99;82;36;3;33;.917;3571150;0
4851;3006;103;0;0;0;0;.00nan;0;0
4851;3360;100;37;11;3;8;.727;520800;0
4851;3440;103;92;17;0;17;1.000;3600000;0
4851;5260;100;44;28;5;23;.821;3079200;0
4853;2991;96;0;0;0;0;.00nan;0;0
4853;3193;96;92;28;1;27;.964;3586650;0
4853;3228;92;0;0;0;0;.00nan;0;0
4853;3429;92;80;11;0;11;1.000;3600000;0
4855;3029;98;70;34;4;30;.882;3600000;0
4855;3136;101;0;0;0;0;.00nan;0;0
4855;3215;101;100;34;1;33;.971;3600000;0
4855;3472;98;0;0;0;0;.00nan;0;0
4857;2987;88;26;28;7;21;.750;2982600;0
4857;3022;88;62;8;0;8;1.000;617400;0
4857;3270;93;0;0;0;0;.00nan;0;0
4857;3394;93;63;19;2;17;.895;3600000;0
4859;3141;105;100;25;0;25;1.000;3600000;0
4859;3246;86;86;45;4;41;.911;3600000;0
4859;3266;86;0;0;0;0;.00nan;0;0
4859;4873;105;0;0;0;0;.00nan;0;0
4861;3136;101;90;27;1;26;.963;3600000;0
4861;3215;101;0;0;0;0;.00nan;0;0
4861;3273;95;44;33;6;27;.818;2667500;0
4861;3316;95;61;7;0;7;1.000;932500;0
4863;3111;90;0;0;0;0;.00nan;0;0
4863;3159;97;58;35;5;30;.857;3600000;0
4863;3217;90;87;32;2;30;.938;3600000;0
4863;3323;97;0;0;0;0;.00nan;0;0
4865;3233;91;85;31;2;29;.935;3600000;0
4865;3417;89;62;32;4;28;.875;3510200;0
4865;5200;89;0;0;0;0;.00nan;0;0
4865;5262;91;0;0;0;0;.00nan;0;0
4867;3141;105;70;17;1;16;.941;3600000;0
4867;3410;99;59;34;5;29;.853;3600000;0
4867;4873;105;0;0;0;0;.00nan;0;0
4867;5261;99;0;0;0;0;.00nan;0;0
4869;2991;96;53;37;6;31;.838;3541900;0
4869;3193;96;0;0;0;0;.00nan;0;0
4869;3246;86;0;0;0;0;.00nan;0;0
4869;3266;86;57;27;4;23;.852;3600000;0
4871;2987;88;0;0;0;0;.00nan;0;0
4871;3022;88;37;30;6;24;.800;3600000;0
4871;3029;98;55;21;3;18;.857;3600000;0
4871;3472;98;0;0;0;0;.00nan;0;0
4873;3006;103;83;43;4;39;.907;3546400;0
4873;3147;87;0;0;0;0;.00nan;0;0
4873;3299;87;94;41;3;38;.927;3600000;0
4873;3440;103;0;0;0;0;.00nan;0;0
4875;3034;104;0;0;0;0;.00nan;0;0
4875;3272;104;76;33;3;30;.909;3711250;0
4875;3360;100;77;27;2;25;.926;3711250;0
4875;5260;100;0;0;0;0;.00nan;0;0
4877;3228;92;61;6;0;6;1.000;876350;0
4877;3270;93;21;9;4;5;.556;766000;0
4877;3394;93;36;29;6;23;.793;2834000;0
4877;3429;92;40;36;7;29;.806;2723650;0
4879;3043;102;61;31;4;27;.871;3560000;0
4879;3104;94;86;32;2;30;.938;3600000;0
4879;3435;102;0;0;0;0;.00nan;0;0
4879;4750;94;0;0;0;0;.00nan;0;0
4881;3159;97;0;0;0;0;.00nan;0;0
4881;3270;93;97;37;2;35;.946;3600000;0
4881;3323;97;94;53;4;49;.925;3586050;0
4881;3394;93;0;0;0;0;.00nan;0;0
4883;2991;96;0;0;0;0;.00nan;0;0
4883;3111;90;0;0;0;0;.00nan;0;0
4883;3193;96;100;46;3;43;.935;3900000;0
4883;3217;90;55;24;3;21;.875;3900000;0
4885;3034;104;68;41;5;36;.878;3600000;0
4885;3246;86;92;38;3;35;.921;3600000;0
4885;3266;86;0;0;0;0;.00nan;0;0
4885;3272;104;0;0;0;0;.00nan;0;0
4887;3029;98;0;0;0;0;.00nan;0;0
4887;3273;95;0;0;0;0;.00nan;0;0
4887;3316;95;72;18;1;17;.944;3600000;0
4887;3472;98;64;26;3;23;.885;3600000;0
4889;3043;102;0;0;0;0;.00nan;0;0
4889;3233;91;51;25;4;21;.840;3600000;0
4889;3435;102;94;30;1;29;.967;3600000;0
4889;5262;91;0;0;0;0;.00nan;0;0
4891;3215;101;46;20;4;16;.800;3781550;0
4891;3229;101;0;0;0;0;.00nan;0;0
4891;3360;100;0;0;0;0;.00nan;0;0
4891;5260;100;77;43;5;38;.884;3766200;0
4893;3228;92;56;21;3;18;.857;3600000;0
4893;3417;89;0;0;0;0;.00nan;0;0
4893;3429;92;0;0;0;0;.00nan;0;0
4893;5200;89;75;39;4;35;.897;3600000;0
4895;3006;103;0;0;0;0;.00nan;0;0
4895;3147;87;79;41;4;37;.902;3559250;0
4895;3299;87;0;0;0;0;.00nan;0;0
4895;3440;103;72;23;2;21;.913;3600000;0
4897;3104;94;0;0;0;0;.00nan;0;0
4897;3410;99;61;31;4;27;.871;3055750;0
4897;4750;94;66;15;1;14;.933;3600000;0
4897;5261;99;23;4;3;1;.250;544250;0
4899;3022;88;69;40;5;35;.875;3600000;0
4899;3136;88;0;0;0;0;.00nan;0;0
4899;3141;105;37;12;3;9;.750;1217900;0
4899;4873;105;48;30;5;25;.833;2382100;0
3144;2541;65;75;33;3;30;.909;3557350;0
3144;2794;64;86;32;2;30;.938;3600000;0
3144;2812;65;0;0;0;0;.00nan;0;0
3144;2922;64;0;0;0;0;.00nan;0;0
3145;2516;71;100;27;0;27;1.000;3600000;0
3145;2650;73;0;0;0;0;.00nan;0;0
3145;2741;73;84;36;3;33;.917;3600000;0
3145;2968;71;0;0;0;0;.00nan;0;0
3146;2505;76;0;0;0;0;.00nan;0;0
3146;2760;82;54;33;5;28;.848;3600000;0
3146;2771;82;0;0;0;0;.00nan;0;0
3146;2864;76;81;34;3;31;.912;3600000;0
3147;2476;67;45;33;6;27;.818;2943150;0
3147;2532;66;0;0;0;0;.00nan;0;0
3147;2710;66;88;31;2;29;.935;3600000;0
3147;2758;67;43;3;1;2;.667;656850;0
3148;2883;78;0;0;0;0;.00nan;0;0
3148;2960;78;76;20;1;19;.950;3600000;0
3148;3187;84;52;7;1;6;.857;811000;0
3148;3348;84;45;32;6;26;.813;2789000;0
3149;2616;83;90;28;1;27;.964;3600000;0
3149;2672;79;0;0;0;0;.00nan;0;0
3149;2967;83;0;0;0;0;.00nan;0;0
3149;5082;79;57;23;3;20;.870;3534750;0
3150;2510;69;0;0;0;0;.00nan;0;0
3150;2531;68;0;0;0;0;.00nan;0;0
3150;2692;68;75;26;2;24;.923;3586100;0
3150;2845;69;100;36;1;35;.972;3600000;0
3151;2818;80;0;0;0;0;.00nan;0;0
3151;2962;80;74;25;2;23;.920;3600000;0
3151;3013;85;67;37;5;32;.865;3600000;0
3151;3173;85;0;0;0;0;.00nan;0;0
3152;2522;77;100;26;0;26;1.000;3600000;0
3152;2752;77;0;0;0;0;.00nan;0;0
3152;2760;82;0;0;0;0;.00nan;0;0
3152;2771;82;41;25;5;20;.800;3600000;0
3153;2476;67;100;34;0;34;1.000;3600000;0
3153;2758;67;0;0;0;0;.00nan;0;0
3153;2794;64;0;0;0;0;.00nan;0;0
3153;2922;64;77;38;4;34;.895;3600000;0
3154;2593;81;52;25;4;21;.840;3600000;0
3154;2600;81;0;0;0;0;.00nan;0;0
3154;2672;79;98;32;1;31;.969;3600000;0
3154;5082;79;0;0;0;0;.00nan;0;0
3155;2650;73;0;0;0;0;.00nan;0;0
3155;2741;73;79;46;5;41;.891;3600000;0
3155;2773;75;90;16;0;16;1.000;3600000;0
3155;5171;75;0;0;0;0;.00nan;0;0
3156;2516;71;63;34;5;29;.853;3555300;0
3156;2655;74;57;27;4;23;.852;3600000;0
3156;2708;74;0;0;0;0;.00nan;0;0
3156;2968;71;0;0;0;0;.00nan;0;0
3157;2532;66;0;0;0;0;.00nan;0;0
3157;2541;65;51;31;5;26;.839;3600000;0
3157;2710;66;73;31;4;27;.871;3600000;0
3157;2812;65;0;0;0;0;.00nan;0;0
3158;2883;78;0;0;0;0;.00nan;0;0
3158;2960;78;72;18;1;17;.944;3600000;0
3158;3187;84;41;20;4;16;.800;1096500;0
3158;3348;84;88;26;1;25;.962;2503500;0
3159;2616;83;83;30;2;28;.933;3600000;0
3159;2967;83;0;0;0;0;.00nan;0;0
3159;4930;72;57;5;0;5;1.000;590100;0
3159;4962;72;44;34;6;28;.824;3009900;0
3160;2510;69;70;29;3;26;.897;3600000;0
3160;2531;68;0;0;0;0;.00nan;0;0
3160;2692;68;78;27;2;25;.926;3600000;0
3160;2845;69;0;0;0;0;.00nan;0;0
3161;2818;80;93;35;3;32;.914;3900000;0
3161;2962;80;0;0;0;0;.00nan;0;0
3161;3013;85;96;41;3;38;.927;3900000;0
3161;3173;85;0;0;0;0;.00nan;0;0
3162;2522;77;100;36;0;36;1.000;3600000;0
3162;2752;77;0;0;0;0;.00nan;0;0
3162;2818;80;85;26;1;25;.962;3600000;0
3162;2962;80;0;0;0;0;.00nan;0;0
3163;2532;66;0;0;0;0;.00nan;0;0
3163;2710;66;68;28;3;25;.893;3568400;0
3163;2794;64;0;0;0;0;.00nan;0;0
3163;2922;64;82;24;1;23;.958;3600000;0
3164;2510;69;60;20;3;17;.850;3545700;0
3164;2650;73;0;0;0;0;.00nan;0;0
3164;2741;73;100;51;2;49;.961;3600000;0
3164;2845;69;0;0;0;0;.00nan;0;0
3165;2505;76;0;0;0;0;.00nan;0;0
3165;2616;83;65;32;4;28;.875;3600000;0
3165;2864;76;72;42;5;37;.881;3576500;0
3165;2967;83;0;0;0;0;.00nan;0;0
3166;2655;74;74;24;2;22;.917;3558950;0
3166;2708;74;0;0;0;0;.00nan;0;0
3166;2773;75;81;23;1;22;.957;3600000;0
3166;5171;75;0;0;0;0;.00nan;0;0
3167;2672;79;53;25;4;21;.840;3600000;0
3167;2883;78;0;0;0;0;.00nan;0;0
3167;2960;78;61;37;5;32;.865;3565050;0
3167;5082;79;0;0;0;0;.00nan;0;0
3168;3187;84;0;0;0;0;.00nan;0;0
3168;3348;84;78;25;2;23;.920;3600000;0
3168;4930;72;0;0;0;0;.00nan;0;0
3168;4962;72;46;23;4;19;.826;3513850;0
3169;2476;67;88;27;1;26;.963;3600000;0
3169;2541;65;77;28;2;26;.929;3600000;0
3169;2758;67;0;0;0;0;.00nan;0;0
3169;2812;65;0;0;0;0;.00nan;0;0
3170;2516;71;57;29;4;25;.862;2197100;0
3170;2968;71;57;11;1;10;.909;1358650;0
3170;4931;70;87;35;3;32;.914;3600000;0
3170;5140;70;0;0;0;0;.00nan;0;0
3171;2531;68;64;26;3;23;.885;3600000;0
3171;2692;68;0;0;0;0;.00nan;0;0
3171;2794;64;0;0;0;0;.00nan;0;0
3171;2922;64;48;29;5;24;.828;3537250;0
3172;2593;81;70;28;3;25;.893;3553750;0
3172;2600;81;0;0;0;0;.00nan;0;0
3172;2760;82;0;0;0;0;.00nan;0;0
3172;2771;82;81;28;2;26;.929;3600000;0
3173;2505;76;73;38;4;34;.895;3572950;0
3173;2818;80;70;28;3;25;.893;3600000;0
3173;2864;76;0;0;0;0;.00nan;0;0
3173;2962;80;0;0;0;0;.00nan;0;0
3174;2655;74;0;0;0;0;.00nan;0;0
3174;2708;74;87;24;1;23;.958;3600000;0
3174;2773;75;44;4;1;3;.750;810700;0
3174;5171;75;40;31;6;25;.806;2789300;0
3175;2510;69;97;43;3;40;.930;3600000;0
3175;2532;66;57;29;4;25;.862;3543100;0
3175;2710;66;0;0;0;0;.00nan;0;0
3175;2845;69;0;0;0;0;.00nan;0;0
3176;2616;83;0;0;0;0;.00nan;0;0
3176;2967;83;78;32;3;29;.906;3600000;0
3176;4930;72;55;38;6;32;.842;3600000;0
3176;4962;72;0;0;0;0;.00nan;0;0
3177;3013;85;0;0;0;0;.00nan;0;0
3177;3173;85;65;26;3;23;.885;3600000;0
3177;3187;84;45;27;5;22;.815;3513100;0
3177;3348;84;0;0;0;0;.00nan;0;0
3178;2650;73;55;4;0;4;1.000;289300;0
3178;2741;73;16;35;9;26;.743;3310700;0
3178;4931;70;88;25;1;24;.960;3600000;0
3178;5140;70;0;0;0;0;.00nan;0;0
3179;2522;77;64;32;4;28;.875;3585150;0
3179;2593;81;0;0;0;0;.00nan;0;0
3179;2600;81;84;31;2;29;.935;3600000;0
3179;2752;77;0;0;0;0;.00nan;0;0
3180;2883;78;0;0;0;0;.00nan;0;0
3180;2960;78;60;17;2;15;.882;3600000;0
3180;4930;72;0;0;0;0;.00nan;0;0
3180;4962;72;71;37;4;33;.892;3552550;0
3181;2476;67;82;43;4;39;.907;3600000;0
3181;2541;65;72;30;3;27;.900;3600000;0
3181;2758;67;0;0;0;0;.00nan;0;0
3181;2812;65;0;0;0;0;.00nan;0;0
3182;2531;68;0;0;0;0;.00nan;0;0
3182;2692;68;77;30;3;27;.900;3900000;0
3182;4931;70;0;0;0;0;.00nan;0;0
3182;5140;70;81;35;3;32;.914;3900000;0
3183;2522;77;0;0;0;0;.00nan;0;0
3183;2752;77;74;23;2;21;.913;3630850;0
3183;2883;78;0;0;0;0;.00nan;0;0
3183;2960;78;73;29;3;26;.897;3630850;0
3184;2522;77;61;30;4;26;.867;3587050;0
3184;2752;77;0;0;0;0;.00nan;0;0
3184;3187;84;0;0;0;0;.00nan;0;0
3184;3348;84;79;26;2;24;.923;3600000;0
3185;2516;71;12;16;6;10;.625;1975150;0
3185;2794;64;100;40;1;39;.975;3600000;0
3185;2922;64;0;0;0;0;.00nan;0;0
3185;2968;71;20;7;4;3;.429;1624850;0
3186;2532;66;80;33;3;30;.909;3821500;0
3186;2593;81;95;37;2;35;.946;3821500;0
3186;2600;81;0;0;0;0;.00nan;0;0
3186;2710;66;0;0;0;0;.00nan;0;0
3187;2541;65;76;26;2;24;.923;3600000;0
3187;2650;73;90;51;5;46;.902;3600000;0
3187;2741;73;0;0;0;0;.00nan;0;0
3187;2812;65;0;0;0;0;.00nan;0;0
3188;2505;76;0;0;0;0;.00nan;0;0
3188;2672;79;69;16;1;15;.938;3600000;0
3188;2864;76;34;32;7;25;.781;3600000;0
3188;5082;79;0;0;0;0;.00nan;0;0
3189;2655;74;66;33;4;29;.879;3631450;0
3189;2708;74;0;0;0;0;.00nan;0;0
3189;2773;75;70;41;5;36;.878;3631450;0
3189;5171;75;0;0;0;0;.00nan;0;0
3190;2760;82;0;0;0;0;.00nan;0;0
3190;2771;82;82;42;4;38;.905;3600000;0
3190;2818;80;0;0;0;0;.00nan;0;0
3190;2962;80;79;27;2;25;.926;3600000;0
3191;2616;83;98;44;2;42;.955;3586500;0
3191;2883;78;84;25;1;24;.960;3600000;0
3191;2960;78;0;0;0;0;.00nan;0;0
3191;2967;83;0;0;0;0;.00nan;0;0
3192;2510;69;0;0;0;0;.00nan;0;0
3192;2531;68;0;0;0;0;.00nan;0;0
3192;2692;68;93;43;3;40;.930;3600000;0
3192;2845;69;54;14;2;12;.857;3600000;0
3193;2773;75;100;22;0;22;1.000;3600000;0
3193;4931;70;59;23;3;20;.870;3600000;0
3193;5140;70;0;0;0;0;.00nan;0;0
3193;5171;75;0;0;0;0;.00nan;0;0
3194;2522;77;0;0;0;0;.00nan;0;0
3194;2752;77;77;20;1;19;.950;3600000;0
3194;3013;85;47;21;4;17;.810;3600000;0
3194;3173;85;0;0;0;0;.00nan;0;0
3195;2510;69;83;23;1;22;.957;3600000;0
3195;2794;64;0;0;0;0;.00nan;0;0
3195;2845;69;0;0;0;0;.00nan;0;0
3195;2922;64;81;40;4;36;.900;3600000;0
3196;2531;68;95;44;3;41;.932;3600000;0
3196;2593;81;0;0;0;0;.00nan;0;0
3196;2600;81;65;33;4;29;.879;3562350;0
3196;2692;68;0;0;0;0;.00nan;0;0
3197;2476;67;0;0;0;0;.00nan;0;0
3197;2516;71;66;33;4;29;.879;3600000;0
3197;2758;67;48;30;5;25;.833;3552000;0
3197;2968;71;0;0;0;0;.00nan;0;0
3198;2541;65;0;0;0;0;.00nan;0;0
3198;2655;74;0;0;0;0;.00nan;0;0
3198;2708;74;38;29;6;23;.793;3600000;0
3198;2812;65;68;16;1;15;.938;3600000;0
3199;2760;82;56;33;5;28;.848;3526900;0
3199;2771;82;0;0;0;0;.00nan;0;0
3199;2883;78;0;0;0;0;.00nan;0;0
3199;2960;78;67;27;3;24;.889;3600000;0
3200;2616;83;0;0;0;0;.00nan;0;0
3200;2967;83;70;23;2;21;.913;3600000;0
3200;3187;84;98;52;3;49;.942;3587750;0
3200;3348;84;0;0;0;0;.00nan;0;0
3201;2818;80;100;24;0;24;1.000;3600000;0
3201;2962;80;0;0;0;0;.00nan;0;0
3201;4930;72;68;28;3;25;.893;3600000;0
3201;4962;72;0;0;0;0;.00nan;0;0
3202;2672;79;50;34;5;29;.853;3575000;0
3202;4931;70;0;0;0;0;.00nan;0;0
3202;5082;79;0;0;0;0;.00nan;0;0
3202;5140;70;30;18;4;14;.778;3600000;0
3203;2505;76;62;30;3;27;.900;3576000;0
3203;2864;76;0;0;0;0;.00nan;0;0
3203;4930;72;0;0;0;0;.00nan;0;0
3203;4962;72;79;30;2;28;.933;3600000;0
3204;2593;81;68;26;2;24;.923;3600000;0
3204;2600;81;0;0;0;0;.00nan;0;0
3204;2794;64;0;0;0;0;.00nan;0;0
3204;2922;64;53;30;4;26;.867;3584000;0
3205;2760;82;0;0;0;0;.00nan;0;0
3205;2771;82;89;40;3;37;.925;3900000;0
3205;2883;78;0;0;0;0;.00nan;0;0
3205;2960;78;55;25;3;22;.880;3900000;0
3206;2672;79;74;16;0;16;1.000;1258000;0
3206;2773;75;68;22;2;20;.909;3600000;0
3206;5082;79;46;22;4;18;.818;2342000;0
3206;5171;75;0;0;0;0;.00nan;0;0
3207;2616;83;72;22;1;21;.955;3600000;0
3207;2967;83;0;0;0;0;.00nan;0;0
3207;3013;85;0;0;0;0;.00nan;0;0
3207;3173;85;54;36;5;31;.861;3600000;0
3208;2510;69;45;5;1;4;.800;420000;0
3208;2845;69;31;35;7;28;.800;3180000;0
3208;4931;70;40;20;4;16;.800;3600000;0
3208;5140;70;0;0;0;0;.00nan;0;0
3209;2476;67;93;39;1;38;.974;3600000;0
3209;2593;81;0;0;0;0;.00nan;0;0
3209;2600;81;59;31;4;27;.871;3600000;0
3209;2758;67;0;0;0;0;.00nan;0;0
3210;2655;74;71;24;2;22;.917;3600000;0
3210;2708;74;0;0;0;0;.00nan;0;0
3210;2773;75;56;39;5;34;.872;3600000;0
3210;5171;75;0;0;0;0;.00nan;0;0
3211;2532;66;0;0;0;0;.00nan;0;0
3211;2710;66;85;19;0;19;1.000;3600000;0
3211;3187;84;56;15;1;14;.933;1564000;0
3211;3348;84;12;18;6;12;.667;2036000;0
3212;2760;82;30;32;6;26;.813;2076000;0
3212;2771;82;70;16;1;15;.938;1524000;0
3212;2883;78;67;17;1;16;.941;3600000;0
3212;2960;78;0;0;0;0;.00nan;0;0
3213;2522;77;67;25;2;23;.920;3600000;0
3213;2752;77;0;0;0;0;.00nan;0;0
3213;2760;82;0;0;0;0;.00nan;0;0
3213;2771;82;79;28;3;25;.893;3600000;0
3214;2655;74;63;26;2;24;.923;3600000;0
3214;2708;74;0;0;0;0;.00nan;0;0
3214;2794;64;0;0;0;0;.00nan;0;0
3214;2922;64;66;32;3;29;.906;3591000;0
3215;2541;65;54;17;2;15;.882;3600000;0
3215;2593;81;74;48;5;43;.896;3600000;0
3215;2600;81;0;0;0;0;.00nan;0;0
3215;2812;65;0;0;0;0;.00nan;0;0
3216;2650;73;0;0;0;0;.00nan;0;0
3216;2672;79;64;27;3;24;.889;3900000;0
3216;2741;73;68;35;3;32;.914;3900000;0
3216;5082;79;0;0;0;0;.00nan;0;0
3217;2505;76;0;0;0;0;.00nan;0;0
3217;2616;83;61;35;4;31;.886;3600000;0
3217;2864;76;67;25;3;22;.880;3600000;0
3217;2967;83;0;0;0;0;.00nan;0;0
3218;2531;68;0;0;0;0;.00nan;0;0
3218;2692;68;71;40;5;35;.875;3900000;0
3218;3187;84;61;38;5;33;.868;3900000;0
3218;3348;84;0;0;0;0;.00nan;0;0
3219;2476;67;89;32;2;30;.938;3600000;0
3219;2510;69;34;21;4;17;.810;3515000;0
3219;2758;67;0;0;0;0;.00nan;0;0
3219;2845;69;0;0;0;0;.00nan;0;0
3220;2818;80;54;34;5;29;.853;3600000;0
3220;2962;80;0;0;0;0;.00nan;0;0
3220;4930;72;63;18;1;17;.944;3600000;0
3220;4962;72;0;0;0;0;.00nan;0;0
3221;2650;73;64;23;2;21;.913;3600000;0
3221;2741;73;0;0;0;0;.00nan;0;0
3221;2794;64;61;30;3;27;.900;3555000;0
3221;2922;64;0;0;0;0;.00nan;0;0
3222;2510;69;0;0;0;0;.00nan;0;0
3222;2593;81;53;2;0;2;1.000;324000;0
3222;2600;81;62;47;6;41;.872;3276000;0
3222;2845;69;72;33;3;30;.909;3600000;0
3223;2516;71;0;0;0;0;.00nan;0;0
3223;2773;75;49;25;4;21;.840;3579000;0
3223;2968;71;74;30;2;28;.933;3600000;0
3223;5171;75;0;0;0;0;.00nan;0;0
3224;2505;76;50;40;6;34;.850;3600000;0
3224;2864;76;0;0;0;0;.00nan;0;0
3224;3013;85;71;24;2;22;.917;3600000;0
3224;3173;85;0;0;0;0;.00nan;0;0
3225;2655;74;0;0;0;0;.00nan;0;0
3225;2672;79;0;0;0;0;.00nan;0;0
3225;2708;74;54;16;3;13;.813;3600000;0
3225;5082;79;57;45;5;40;.889;3581000;0
3226;2532;66;0;0;0;0;.00nan;0;0
3226;2710;66;41;20;3;17;.850;3900000;0
3226;2883;78;0;0;0;0;.00nan;0;0
3226;2960;78;83;42;3;39;.929;3900000;0
3227;2616;83;0;0;0;0;.00nan;0;0
3227;2760;82;74;32;3;29;.906;3900000;0
3227;2771;82;0;0;0;0;.00nan;0;0
3227;2967;83;59;32;3;29;.906;3900000;0
3228;2531;68;68;29;3;26;.897;3600000;0
3228;2541;65;58;32;4;28;.875;3600000;0
3228;2692;68;0;0;0;0;.00nan;0;0
3228;2812;65;0;0;0;0;.00nan;0;0
3229;2818;80;0;0;0;0;.00nan;0;0
3229;2962;80;94;38;3;35;.921;3756000;0
3229;4930;72;0;0;0;0;.00nan;0;0
3229;4962;72;55;20;2;18;.900;3756000;0
3230;2505;76;0;0;0;0;.00nan;0;0
3230;2864;76;27;19;5;14;.737;3538000;0
3230;3013;85;0;0;0;0;.00nan;0;0
3230;3173;85;63;29;3;26;.897;3600000;0
3231;2476;67;17;21;6;15;.714;1523000;0
3231;2758;67;59;12;1;11;.917;2077000;0
3231;3187;84;0;0;0;0;.00nan;0;0
3231;3348;84;73;33;4;29;.879;3600000;0
3232;2883;78;0;0;0;0;.00nan;0;0
3232;2960;78;63;37;5;32;.865;3600000;0
3232;4931;70;0;0;0;0;.00nan;0;0
3232;5140;70;54;18;2;16;.889;3600000;0
3233;2522;77;41;25;5;20;.800;3557000;0
3233;2532;66;0;0;0;0;.00nan;0;0
3233;2710;66;67;26;2;24;.923;3600000;0
3233;2752;77;0;0;0;0;.00nan;0;0
3234;2516;71;35;26;6;20;.769;3600000;0
3234;2672;79;0;0;0;0;.00nan;0;0
3234;2968;71;0;0;0;0;.00nan;0;0
3234;5082;79;58;22;2;20;.909;3600000;0
3235;2505;76;0;0;0;0;.00nan;0;0
3235;2532;66;68;30;3;27;.900;3600000;0
3235;2710;66;0;0;0;0;.00nan;0;0
3235;2864;76;72;21;1;20;.952;3600000;0
3236;2476;67;67;28;2;26;.929;3600000;0
3236;2531;68;0;0;0;0;.00nan;0;0
3236;2692;68;33;36;6;30;.833;3600000;0
3236;2758;67;0;0;0;0;.00nan;0;0
3237;2541;65;77;30;2;28;.933;3600000;0
3237;2812;65;0;0;0;0;.00nan;0;0
3237;3187;84;46;35;5;30;.857;3600000;0
3237;3348;84;0;0;0;0;.00nan;0;0
3238;2773;75;98;51;3;48;.941;3577000;0
3238;4931;70;68;27;2;25;.926;3600000;0
3238;5140;70;0;0;0;0;.00nan;0;0
3238;5171;75;0;0;0;0;.00nan;0;0
3239;2794;64;0;0;0;0;.00nan;0;0
3239;2922;64;72;24;2;22;.917;3622000;0
3239;3187;84;0;0;0;0;.00nan;0;0
3239;3348;84;66;30;3;27;.900;3622000;0
3240;2655;74;49;20;3;17;.850;3555000;0
3240;2708;74;0;0;0;0;.00nan;0;0
3240;2883;78;0;0;0;0;.00nan;0;0
3240;2960;78;87;35;1;34;.971;3600000;0
3241;2516;71;83;32;2;30;.938;3900000;0
3241;2531;68;0;0;0;0;.00nan;0;0
3241;2692;68;73;23;2;21;.913;3900000;0
3241;2968;71;0;0;0;0;.00nan;0;0
3242;2505;76;77;20;1;19;.950;3012000;0
3242;2760;82;0;0;0;0;.00nan;0;0
3242;2771;82;79;37;2;35;.946;3600000;0
3242;2864;76;31;12;3;9;.750;571000;0
3243;2522;77;80;38;3;35;.921;3797000;0
3243;2752;77;0;0;0;0;.00nan;0;0
3243;4930;72;40;19;4;15;.789;3797000;0
3243;4962;72;0;0;0;0;.00nan;0;0
3244;2616;83;80;30;2;28;.933;3600000;0
3244;2794;64;44;20;3;17;.850;3552000;0
3244;2922;64;0;0;0;0;.00nan;0;0
3244;2967;83;0;0;0;0;.00nan;0;0
3245;2650;73;0;0;0;0;.00nan;0;0
3245;2741;73;75;20;1;19;.950;3900000;0
3245;2883;78;0;0;0;0;.00nan;0;0
3245;2960;78;82;27;1;26;.963;3900000;0
3246;2541;65;81;46;4;42;.913;3566000;0
3246;2655;74;69;21;2;19;.905;3600000;0
3246;2708;74;0;0;0;0;.00nan;0;0
3246;2812;65;0;0;0;0;.00nan;0;0
3247;2532;66;0;0;0;0;.00nan;0;0
3247;2710;66;66;27;2;25;.926;3600000;0
3247;2818;80;57;34;4;30;.882;3534000;0
3247;2962;80;0;0;0;0;.00nan;0;0
3248;2510;69;69;28;2;26;.929;3600000;0
3248;2845;69;0;0;0;0;.00nan;0;0
3248;3187;84;12;16;6;10;.625;1608000;0
3248;3348;84;47;21;3;18;.857;1992000;0
3249;2650;73;36;39;7;32;.821;3600000;0
3249;2741;73;0;0;0;0;.00nan;0;0
3249;4931;70;76;23;1;22;.957;3600000;0
3249;5140;70;0;0;0;0;.00nan;0;0
3250;2522;77;0;0;0;0;.00nan;0;0
3250;2752;77;66;33;3;30;.909;3600000;0
3250;3013;85;47;31;5;26;.839;3558000;0
3250;3173;85;0;0;0;0;.00nan;0;0
3251;2593;81;60;19;2;17;.895;3600000;0
3251;2600;81;0;0;0;0;.00nan;0;0
3251;2760;82;0;0;0;0;.00nan;0;0
3251;2771;82;69;45;5;40;.889;3600000;0
3252;2505;76;0;0;0;0;.00nan;0;0
3252;2864;76;43;27;5;22;.815;3900000;0
3252;4930;72;0;0;0;0;.00nan;0;0
3252;4962;72;32;23;5;18;.783;3900000;0
3253;2532;66;53;28;4;24;.857;3600000;0
3253;2672;79;88;38;3;35;.921;3600000;0
3253;2710;66;0;0;0;0;.00nan;0;0
3253;5082;79;0;0;0;0;.00nan;0;0
3254;2531;68;0;0;0;0;.00nan;0;0
3254;2692;68;98;36;1;35;.972;3598000;0
3254;2773;75;92;21;0;21;1.000;3600000;0
3254;5171;75;0;0;0;0;.00nan;0;0
3255;2476;67;0;0;0;0;.00nan;0;0
3255;2616;83;66;39;4;35;.897;3600000;0
3255;2758;67;73;17;1;16;.941;3600000;0
3255;2967;83;0;0;0;0;.00nan;0;0
3256;2510;69;0;0;0;0;.00nan;0;0
3256;2541;65;0;0;0;0;.00nan;0;0
3256;2812;65;52;34;4;30;.882;3600000;0
3256;2845;69;65;29;3;26;.897;3600000;0
3257;2516;71;65;24;2;22;.917;3550000;0
3257;2773;75;95;33;1;32;.970;3600000;0
3257;2968;71;0;0;0;0;.00nan;0;0
3257;5171;75;0;0;0;0;.00nan;0;0
3258;2760;82;81;33;3;30;.909;3578000;0
3258;2771;82;0;0;0;0;.00nan;0;0
3258;3013;85;0;0;0;0;.00nan;0;0
3258;3173;85;79;24;1;23;.958;3600000;0
3259;2672;79;0;0;0;0;.00nan;0;0
3259;4930;72;79;30;2;28;.933;3600000;0
3259;4962;72;0;0;0;0;.00nan;0;0
3259;5082;79;66;36;3;33;.917;3600000;0
3260;2505;76;0;0;0;0;.00nan;0;0
3260;2818;80;38;18;3;15;.833;3600000;0
3260;2864;76;64;35;4;31;.886;3600000;0
3260;2962;80;0;0;0;0;.00nan;0;0
3261;2541;65;59;29;3;26;.897;3600000;0
3261;2616;83;57;36;5;31;.861;3541000;0
3261;2812;65;0;0;0;0;.00nan;0;0
3261;2967;83;0;0;0;0;.00nan;0;0
3262;2655;74;0;0;0;0;.00nan;0;0
3262;2708;74;74;31;2;29;.935;3600000;0
3262;4931;70;54;25;3;22;.880;3554000;0
3262;5140;70;0;0;0;0;.00nan;0;0
3263;2522;77;72;37;3;34;.919;3600000;0
3263;2752;77;0;0;0;0;.00nan;0;0
3263;2818;80;0;0;0;0;.00nan;0;0
3263;2962;80;53;33;5;28;.848;3577000;0
3264;2593;81;75;20;1;19;.950;3600000;0
3264;2600;81;0;0;0;0;.00nan;0;0
3264;4930;72;0;0;0;0;.00nan;0;0
3264;4962;72;67;27;2;25;.926;3584000;0
3265;2531;68;0;0;0;0;.00nan;0;0
3265;2616;83;48;27;4;23;.852;3600000;0
3265;2692;68;100;33;0;33;1.000;3600000;0
3265;2967;83;0;0;0;0;.00nan;0;0
3266;2476;67;71;25;2;23;.920;3600000;0
3266;2758;67;0;0;0;0;.00nan;0;0
3266;4931;70;58;27;3;24;.889;3600000;0
3266;5140;70;0;0;0;0;.00nan;0;0
3267;2522;77;75;41;4;37;.902;3571000;0
3267;2541;65;39;16;3;13;.813;3600000;0
3267;2752;77;0;0;0;0;.00nan;0;0
3267;2812;65;0;0;0;0;.00nan;0;0
3268;2531;68;48;8;1;7;.875;1259000;0
3268;2692;68;38;24;4;20;.833;2288000;0
3268;2794;64;64;45;4;41;.911;3600000;0
3268;2922;64;0;0;0;0;.00nan;0;0
3269;2516;71;42;22;4;18;.818;3600000;0
3269;2593;81;0;0;0;0;.00nan;0;0
3269;2600;81;47;33;5;28;.848;3556000;0
3269;2968;71;0;0;0;0;.00nan;0;0
3270;2510;69;78;37;2;35;.946;3600000;0
3270;2650;73;0;0;0;0;.00nan;0;0
3270;2741;73;83;43;3;40;.930;3550000;0
3270;2845;69;0;0;0;0;.00nan;0;0
3271;2655;74;42;27;4;23;.852;3532000;0
3271;2708;74;0;0;0;0;.00nan;0;0
3271;2773;75;0;0;0;0;.00nan;0;0
3271;5171;75;71;28;2;26;.929;3600000;0
3272;2532;66;0;0;0;0;.00nan;0;0
3272;2616;83;80;33;2;31;.939;3600000;0
3272;2710;66;53;31;4;27;.871;3574000;0
3272;2967;83;0;0;0;0;.00nan;0;0
3273;2818;80;76;37;3;34;.919;3600000;0
3273;2883;78;0;0;0;0;.00nan;0;0
3273;2960;78;28;21;5;16;.762;3514000;0
3273;2962;80;0;0;0;0;.00nan;0;0
3274;2672;79;66;17;1;16;.941;3600000;0
3274;3187;84;0;0;0;0;.00nan;0;0
3274;3348;84;79;30;2;28;.933;3544000;0
3274;5082;79;0;0;0;0;.00nan;0;0
3275;3013;85;73;27;2;25;.926;3600000;0
3275;3173;85;0;0;0;0;.00nan;0;0
3275;4930;72;32;7;3;4;.571;356000;0
3275;4962;72;49;21;3;18;.857;3244000;0
3276;2794;64;0;0;0;0;.00nan;0;0
3276;2922;64;74;25;2;23;.920;3600000;0
3276;4931;70;48;0;0;0;.00nan;333000;0
3276;5140;70;12;29;7;22;.759;3267000;0
3277;2593;81;76;26;1;25;.962;3600000;0
3277;2600;81;0;0;0;0;.00nan;0;0
3277;4930;72;0;0;0;0;.00nan;0;0
3277;4962;72;47;31;5;26;.839;3600000;0
3278;2650;73;74;28;2;26;.929;3900000;0
3278;2741;73;0;0;0;0;.00nan;0;0
3278;2773;75;94;40;2;38;.950;3900000;0
3278;5171;75;0;0;0;0;.00nan;0;0
3279;2516;71;0;0;0;0;.00nan;0;0
3279;2760;82;0;0;0;0;.00nan;0;0
3279;2771;82;66;36;4;32;.889;3600000;0
3279;2968;71;40;25;5;20;.800;3531000;0
3280;2505;76;53;6;1;5;.833;576000;0
3280;2541;65;69;24;2;22;.917;3600000;0
3280;2812;65;0;0;0;0;.00nan;0;0
3280;2864;76;21;35;8;27;.771;3024000;0
3281;2476;67;0;0;0;0;.00nan;0;0
3281;2655;74;0;0;0;0;.00nan;0;0
3281;2708;74;67;12;1;11;.917;3600000;0
3281;2758;67;87;45;4;41;.911;3600000;0
3282;2818;80;0;0;0;0;.00nan;0;0
3282;2883;78;100;45;1;44;.978;3600000;0
3282;2960;78;0;0;0;0;.00nan;0;0
3282;2962;80;53;30;4;26;.867;3600000;0
3283;2510;69;0;0;0;0;.00nan;0;0
3283;2616;83;0;0;0;0;.00nan;0;0
3283;2845;69;68;28;2;26;.929;3600000;0
3283;2967;83;49;37;5;32;.865;3600000;0
3284;3013;85;0;0;0;0;.00nan;0;0
3284;3173;85;65;23;2;21;.913;3900000;0
3284;3187;84;59;23;2;21;.913;3900000;0
3284;3348;84;0;0;0;0;.00nan;0;0
3285;2593;81;0;0;0;0;.00nan;0;0
3285;2600;81;52;26;3;23;.885;3900000;0
3285;2760;82;80;45;3;42;.933;3900000;0
3285;2771;82;0;0;0;0;.00nan;0;0
3286;2505;76;52;27;4;23;.852;3600000;0
3286;2672;79;51;8;1;7;.875;1674000;0
3286;2864;76;0;0;0;0;.00nan;0;0
3286;5082;79;51;26;4;22;.846;1856000;0
3287;2516;71;99;31;1;30;.968;3600000;0
3287;2968;71;0;0;0;0;.00nan;0;0
3287;3013;85;61;32;3;29;.906;3600000;0
3287;3173;85;0;0;0;0;.00nan;0;0
3288;2541;65;85;40;2;38;.950;3600000;0
3288;2812;65;0;0;0;0;.00nan;0;0
3288;2883;78;0;0;0;0;.00nan;0;0
3288;2960;78;60;38;5;33;.868;3600000;0
3289;2655;74;17;25;6;19;.760;2563000;0
3289;2708;74;47;7;1;6;.857;1037000;0
3289;4931;70;59;28;3;25;.893;3600000;0
3289;5140;70;0;0;0;0;.00nan;0;0
3290;2510;69;78;36;4;32;.889;3686000;0
3290;2650;73;0;0;0;0;.00nan;0;0
3290;2741;73;68;30;3;27;.900;3686000;0
3290;2845;69;0;0;0;0;.00nan;0;0
3291;2516;71;66;42;4;38;.905;3599000;0
3291;2968;71;0;0;0;0;.00nan;0;0
3291;3187;84;90;41;2;39;.951;3600000;0
3291;3348;84;0;0;0;0;.00nan;0;0
3292;2476;67;65;35;4;31;.886;3900000;0
3292;2532;66;0;0;0;0;.00nan;0;0
3292;2710;66;63;40;4;36;.900;3900000;0
3292;2758;67;0;0;0;0;.00nan;0;0
3293;2650;73;47;8;1;7;.875;1375000;0
3293;2741;73;25;28;6;22;.786;2225000;0
3293;4931;70;78;23;1;22;.957;3600000;0
3293;5140;70;0;0;0;0;.00nan;0;0
3294;2593;81;59;11;1;10;.909;3600000;0
3294;2600;81;0;0;0;0;.00nan;0;0
3294;4930;72;78;39;2;37;.949;3588000;0
3294;4962;72;0;0;0;0;.00nan;0;0
3295;2516;71;82;31;1;30;.968;3600000;0
3295;2616;83;63;36;4;32;.889;3600000;0
3295;2967;83;0;0;0;0;.00nan;0;0
3295;2968;71;0;0;0;0;.00nan;0;0
3296;2505;76;0;0;0;0;.00nan;0;0
3296;2864;76;73;39;3;36;.923;3600000;0
3296;2883;78;0;0;0;0;.00nan;0;0
3296;2960;78;42;22;4;18;.818;3558000;0
3297;2476;67;70;39;4;35;.897;3600000;0
3297;2655;74;56;40;5;35;.875;3590000;0
3297;2708;74;0;0;0;0;.00nan;0;0
3297;2758;67;0;0;0;0;.00nan;0;0
3298;2510;69;0;0;0;0;.00nan;0;0
3298;2532;66;49;42;5;37;.881;3600000;0
3298;2710;66;0;0;0;0;.00nan;0;0
3298;2845;69;84;31;1;30;.968;3600000;0
3299;2760;82;0;0;0;0;.00nan;0;0
3299;2771;82;52;26;4;22;.846;3600000;0
3299;3187;84;0;0;0;0;.00nan;0;0
3299;3348;84;76;28;2;26;.929;3600000;0
3300;2531;68;0;0;0;0;.00nan;0;0
3300;2692;68;62;23;2;21;.913;3600000;0
3300;3392;79;74;33;3;30;.909;3548000;0
3300;5082;79;0;0;0;0;.00nan;0;0
3301;2541;65;0;0;0;0;.00nan;0;0
3301;2812;65;52;33;5;28;.848;3600000;0
3301;2818;80;0;0;0;0;.00nan;0;0
3301;2962;80;78;29;2;27;.931;3600000;0
3302;2655;74;0;0;0;0;.00nan;0;0
3302;2708;74;63;33;3;30;.909;3600000;0
3302;2794;64;76;23;1;22;.957;3600000;0
3302;2922;64;0;0;0;0;.00nan;0;0
3303;2650;73;0;0;0;0;.00nan;0;0
3303;2741;73;35;32;6;26;.813;3522000;0
3303;2773;75;76;43;4;39;.907;3600000;0
3303;5171;75;0;0;0;0;.00nan;0;0
3304;2516;71;77;25;1;24;.960;2426000;0
3304;2968;71;23;9;4;5;.556;1137000;0
3304;4930;72;0;0;0;0;.00nan;0;0
3304;4962;72;56;25;3;22;.880;3600000;0
3305;2616;83;75;34;4;30;.882;3900000;0
3305;2760;82;69;30;4;26;.867;3900000;0
3305;2771;82;0;0;0;0;.00nan;0;0
3305;2967;83;0;0;0;0;.00nan;0;0
3306;3013;85;0;0;0;0;.00nan;0;0
3306;3173;85;89;37;1;36;.973;3600000;0
3306;3187;84;53;26;3;23;.885;3575000;0
3306;3348;84;0;0;0;0;.00nan;0;0
3307;2476;67;0;0;0;0;.00nan;0;0
3307;2510;69;87;40;2;38;.950;3600000;0
3307;2758;67;73;40;4;36;.900;3528000;0
3307;2845;69;0;0;0;0;.00nan;0;0
3308;2541;65;48;27;4;23;.852;3637000;0
3308;2812;65;0;0;0;0;.00nan;0;0
3308;3392;79;47;33;5;28;.848;3637000;0
3308;5082;79;0;0;0;0;.00nan;0;0
3309;2593;81;62;31;3;28;.903;3561000;0
3309;2600;81;0;0;0;0;.00nan;0;0
3309;3013;85;74;32;2;30;.938;3600000;0
3309;3173;85;0;0;0;0;.00nan;0;0
3310;2531;68;0;0;0;0;.00nan;0;0
3310;2692;68;74;32;3;29;.906;3900000;0
3310;2818;80;45;22;3;19;.864;3900000;0
3310;2962;80;0;0;0;0;.00nan;0;0
3311;2773;75;64;39;5;34;.872;3600000;0
3311;4931;70;55;5;0;5;1.000;600000;0
3311;5140;70;18;22;6;16;.727;3000000;0
3311;5171;75;0;0;0;0;.00nan;0;0
3312;2522;77;65;44;5;39;.886;3543000;0
3312;2752;77;0;0;0;0;.00nan;0;0
3312;3187;84;0;0;0;0;.00nan;0;0
3312;3348;84;61;28;3;25;.893;3600000;0
3313;2505;76;0;0;0;0;.00nan;0;0
3313;2818;80;0;0;0;0;.00nan;0;0
3313;2864;76;81;23;1;22;.957;3600000;0
3313;2962;80;51;36;5;31;.861;3600000;0
3314;2476;67;51;19;3;16;.842;3546000;0
3314;2532;66;0;0;0;0;.00nan;0;0
3314;2710;66;83;39;2;37;.949;3600000;0
3314;2758;67;0;0;0;0;.00nan;0;0
3315;2531;68;0;0;0;0;.00nan;0;0
3315;2692;68;88;31;1;30;.968;3600000;0
3315;2883;78;0;0;0;0;.00nan;0;0
3315;2960;78;27;26;6;20;.769;3600000;0
3316;2650;73;52;3;0;3;1.000;346000;0
3316;2655;74;65;24;2;22;.917;3600000;0
3316;2708;74;0;0;0;0;.00nan;0;0
3316;2741;73;40;39;6;33;.846;3254000;0
3317;2505;76;70;46;5;41;.891;3600000;0
3317;2818;80;70;23;2;21;.913;3600000;0
3317;2864;76;0;0;0;0;.00nan;0;0
3317;2962;80;0;0;0;0;.00nan;0;0
3318;2616;83;86;34;2;32;.941;3600000;0
3318;2967;83;0;0;0;0;.00nan;0;0
3318;4931;70;60;24;3;21;.875;3550000;0
3318;5140;70;0;0;0;0;.00nan;0;0
3319;2522;77;67;24;3;21;.875;3900000;0
3319;2531;68;0;0;0;0;.00nan;0;0
3319;2692;68;81;39;3;36;.923;3900000;0
3319;2752;77;0;0;0;0;.00nan;0;0
3320;2476;67;85;24;1;23;.958;3600000;0
3320;2758;67;0;0;0;0;.00nan;0;0
3320;2794;64;78;31;2;29;.935;3539000;0
3320;2922;64;0;0;0;0;.00nan;0;0
3321;2593;81;50;34;5;29;.853;3600000;0
3321;2600;81;0;0;0;0;.00nan;0;0
3321;3013;85;0;0;0;0;.00nan;0;0
3321;3173;85;44;32;6;26;.813;3569000;0
3322;2541;65;32;24;5;19;.792;3900000;0
3322;2650;73;0;0;0;0;.00nan;0;0
3322;2741;73;73;40;5;35;.875;3896000;0
3322;2812;65;0;0;0;0;.00nan;0;0
3323;2516;71;42;30;4;26;.867;3600000;0
3323;2655;74;94;16;0;16;1.000;3600000;0
3323;2708;74;0;0;0;0;.00nan;0;0
3323;2968;71;0;0;0;0;.00nan;0;0
3324;2505;76;73;29;2;27;.931;3600000;0
3324;2864;76;0;0;0;0;.00nan;0;0
3324;3187;84;38;34;6;28;.824;3600000;0
3324;3348;84;0;0;0;0;.00nan;0;0
3325;2773;75;58;37;5;32;.865;3600000;0
3325;4930;72;0;0;0;0;.00nan;0;0
3325;4962;72;91;21;0;21;1.000;3600000;0
3325;5171;75;0;0;0;0;.00nan;0;0
3326;2593;81;0;0;0;0;.00nan;0;0
3326;2600;81;78;31;2;29;.935;3776000;0
3326;4931;70;0;0;0;0;.00nan;0;0
3326;5140;70;68;31;3;28;.903;3776000;0
3327;2522;77;0;0;0;0;.00nan;0;0
3327;2752;77;54;26;3;23;.885;3900000;0
3327;3187;84;0;0;0;0;.00nan;0;0
3327;3348;84;65;31;3;28;.903;3900000;0
3328;2532;66;0;0;0;0;.00nan;0;0
3328;2710;66;92;35;1;34;.971;3600000;0
3328;2794;64;0;0;0;0;.00nan;0;0
3328;2922;64;45;19;3;16;.842;3514000;0
3329;2510;69;43;25;5;20;.800;3600000;0
3329;2516;71;80;13;0;13;1.000;1041000;0
3329;2845;69;0;0;0;0;.00nan;0;0
3329;2968;71;36;30;6;24;.800;2529000;0
3330;2505;76;0;0;0;0;.00nan;0;0
3330;2531;68;0;0;0;0;.00nan;0;0
3330;2692;68;77;29;2;27;.931;3600000;0
3330;2864;76;84;45;4;41;.911;3548000;0
3331;2541;65;54;38;5;33;.868;3600000;0
3331;2655;74;72;30;2;28;.933;3600000;0
3331;2708;74;0;0;0;0;.00nan;0;0
3331;2812;65;0;0;0;0;.00nan;0;0
3332;2760;82;56;32;3;29;.906;3565000;0
3332;2771;82;0;0;0;0;.00nan;0;0
3332;4930;72;0;0;0;0;.00nan;0;0
3332;4962;72;89;31;1;30;.968;3600000;0
3333;2883;78;62;27;3;24;.889;3557000;0
3333;2960;78;0;0;0;0;.00nan;0;0
3333;3392;79;74;33;2;31;.939;3600000;0
3333;5082;79;0;0;0;0;.00nan;0;0
3334;2773;75;0;0;0;0;.00nan;0;0
3334;3013;85;78;30;2;28;.933;3753000;0
3334;3173;85;0;0;0;0;.00nan;0;0
3334;5171;75;77;37;3;34;.919;3753000;0
3335;2616;83;83;43;3;40;.930;3600000;0
3335;2818;80;33;29;6;23;.793;3600000;0
3335;2962;80;0;0;0;0;.00nan;0;0
3335;2967;83;0;0;0;0;.00nan;0;0
3336;2476;67;80;26;2;24;.923;3675000;0
3336;2650;73;0;0;0;0;.00nan;0;0
3336;2741;73;87;30;1;29;.967;3675000;0
3336;2758;67;0;0;0;0;.00nan;0;0
3337;2883;78;54;6;0;6;1.000;349000;0
3337;2960;78;61;38;5;33;.868;3251000;0
3337;3392;79;69;22;2;20;.909;3600000;0
3337;5082;79;0;0;0;0;.00nan;0;0
3338;3013;85;0;0;0;0;.00nan;0;0
3338;3173;85;59;31;4;27;.871;3600000;0
3338;4931;70;57;25;3;22;.880;3600000;0
3338;5140;70;0;0;0;0;.00nan;0;0
3339;2650;73;58;30;3;27;.900;3594000;0
3339;2741;73;0;0;0;0;.00nan;0;0
3339;2794;64;67;24;2;22;.917;3600000;0
3339;2922;64;0;0;0;0;.00nan;0;0
3340;2593;81;63;33;3;30;.909;3600000;0
3340;2600;81;0;0;0;0;.00nan;0;0
3340;2773;75;67;34;4;30;.882;3547000;0
3340;5171;75;0;0;0;0;.00nan;0;0
3341;2505;76;76;32;3;29;.906;3600000;0
3341;2818;80;0;0;0;0;.00nan;0;0
3341;2864;76;0;0;0;0;.00nan;0;0
3341;2962;80;52;29;4;25;.862;3594000;0
3342;2616;83;69;27;2;25;.926;3600000;0
3342;2773;75;51;36;5;31;.861;3600000;0
3342;2967;83;0;0;0;0;.00nan;0;0
3342;5171;75;0;0;0;0;.00nan;0;0
3343;2510;69;0;0;0;0;.00nan;0;0
3343;2541;65;38;25;5;20;.800;3895000;0
3343;2812;65;0;0;0;0;.00nan;0;0
3343;2845;69;53;29;4;25;.862;3895000;0
4901;2873;72;86;26;1;25;.962;3600000;0
4901;3187;84;0;0;0;0;.00nan;0;0
4901;3348;84;70;29;3;26;.897;3567150;0
4901;4962;72;0;0;0;0;.00nan;0;0
4903;2883;78;0;0;0;0;.00nan;0;0
4903;2960;78;52;32;5;27;.844;3600000;0
4903;3013;85;87;36;3;33;.917;3600000;0
4903;3173;85;0;0;0;0;.00nan;0;0
4905;2532;66;0;0;0;0;.00nan;0;0
4905;2598;73;0;0;0;0;.00nan;0;0
4905;2710;66;100;29;1;28;.966;3600000;0
4905;2741;73;96;49;3;46;.939;3543400;0
4907;2531;68;0;0;0;0;.00nan;0;0
4907;2672;79;32;21;5;16;.762;3513650;0
4907;2692;68;68;28;3;25;.893;3600000;0
4907;2758;79;0;0;0;0;.00nan;0;0
4909;2541;65;70;36;4;32;.889;3542000;0
4909;2593;81;94;41;3;38;.927;3600000;0
4909;2600;81;0;0;0;0;.00nan;0;0
4909;2812;65;0;0;0;0;.00nan;0;0
4911;2794;64;0;0;0;0;.00nan;0;0
4911;2922;64;71;41;5;36;.878;3600000;0
4911;4931;70;52;38;6;32;.842;3157300;0
4911;5140;70;41;2;1;1;.500;392900;0
4913;2516;71;80;36;3;33;.917;3600000;0
4913;2773;75;89;16;0;16;1.000;3600000;0
4913;2968;71;0;0;0;0;.00nan;0;0
4913;5171;75;0;0;0;0;.00nan;0;0
4915;2522;77;88;33;3;30;.909;3855650;0
4915;2752;77;0;0;0;0;.00nan;0;0
4915;2760;82;0;0;0;0;.00nan;0;0
4915;2771;82;71;32;3;29;.906;3900000;0
4917;2476;67;28;24;6;18;.750;3600000;0
4917;2655;74;0;0;0;0;.00nan;0;0
4917;2708;74;72;30;3;27;.900;3600000;0
4917;2818;67;0;0;0;0;.00nan;0;0
4919;2510;69;100;38;1;37;.974;3600000;0
4919;2616;83;0;0;0;0;.00nan;0;0
4919;2624;69;0;0;0;0;.00nan;0;0
4919;2967;83;58;41;6;35;.854;3600000;0
4921;2505;76;0;0;0;0;.00nan;0;0
4921;2777;80;74;25;2;23;.920;3600000;0
4921;2864;76;67;37;5;32;.865;3600000;0
4921;2962;80;0;0;0;0;.00nan;0;0
4923;2655;74;44;22;4;18;.818;3600000;0
4923;2708;74;0;0;0;0;.00nan;0;0
4923;4930;72;0;0;0;0;.00nan;0;0
4923;4962;72;91;31;1;30;.968;3600000;0
4925;2510;69;0;0;0;0;.00nan;0;0
4925;2624;69;39;18;4;14;.778;3600000;0
4925;2760;82;62;42;6;36;.857;3600000;0
4925;2771;82;0;0;0;0;.00nan;0;0
4927;2532;66;0;0;0;0;.00nan;0;0
4927;2710;66;55;30;5;25;.833;3631150;0
4927;2777;80;70;34;4;30;.882;3631150;0
4927;2962;80;0;0;0;0;.00nan;0;0
4929;2476;67;0;0;0;0;.00nan;0;0
4929;2616;83;51;30;5;25;.833;3600000;0
4929;2818;67;66;45;6;39;.867;3600000;0
4929;2967;83;0;0;0;0;.00nan;0;0
4931;2516;71;0;0;0;0;.00nan;0;0
4931;2593;81;95;29;1;28;.966;3600000;0
4931;2600;81;0;0;0;0;.00nan;0;0
4931;2968;71;75;38;4;34;.895;3600000;0
4933;2598;73;57;28;4;24;.857;3600000;0
4933;2741;73;0;0;0;0;.00nan;0;0
4933;3187;84;0;0;0;0;.00nan;0;0
4933;3348;84;84;24;1;23;.958;3600000;0
4935;2541;65;53;26;4;22;.846;3600000;0
4935;2812;65;0;0;0;0;.00nan;0;0
4935;2883;78;0;0;0;0;.00nan;0;0
4935;2960;78;88;39;3;36;.923;3600000;0
4937;2522;77;0;0;0;0;.00nan;0;0
4937;2672;79;0;0;0;0;.00nan;0;0
4937;2752;77;55;26;4;22;.846;3759550;0
4937;2758;79;51;31;5;26;.839;3759550;0
4939;2505;76;0;0;0;0;.00nan;0;0
4939;2864;76;100;35;1;34;.971;3600000;0
4939;3013;85;0;0;0;0;.00nan;0;0
4939;3173;85;66;28;3;25;.893;3534150;0
4941;2531;68;0;0;0;0;.00nan;0;0
4941;2692;68;49;36;6;30;.833;3517100;0
4941;4931;70;68;33;4;29;.879;3600000;0
4941;5140;70;0;0;0;0;.00nan;0;0
4943;2773;75;54;38;6;32;.842;3600000;0
4943;2794;64;0;0;0;0;.00nan;0;0
4943;2922;64;100;41;2;39;.951;3600000;0
4943;5171;75;0;0;0;0;.00nan;0;0
4945;2476;67;65;31;4;27;.871;3600000;0
4945;2655;74;0;0;0;0;.00nan;0;0
4945;2708;74;75;44;5;39;.886;3546950;0
4945;2818;67;0;0;0;0;.00nan;0;0
4947;2760;82;0;0;0;0;.00nan;0;0
4947;2771;82;74;38;4;34;.895;3587950;0
4947;4930;72;74;23;2;21;.913;3600000;0
4947;4962;72;0;0;0;0;.00nan;0;0
4949;2541;65;0;0;0;0;.00nan;0;0
4949;2812;65;60;17;2;15;.882;3600000;0
4949;3187;84;23;27;7;20;.741;3600000;0
4949;3348;84;0;0;0;0;.00nan;0;0
4951;2773;75;0;0;0;0;.00nan;0;0
4951;3013;85;95;37;2;35;.946;3600000;0
4951;3173;85;0;0;0;0;.00nan;0;0
4951;5171;75;62;31;4;27;.871;3522750;0
4953;2531;68;63;25;3;22;.880;3600000;0
4953;2672;79;44;22;4;18;.818;3600000;0
4953;2692;68;0;0;0;0;.00nan;0;0
4953;2758;79;0;0;0;0;.00nan;0;0
4955;2593;81;0;0;0;0;.00nan;0;0
4955;2600;81;96;32;1;31;.969;3676400;0
4955;2883;78;94;40;2;38;.950;3676400;0
4955;2960;78;0;0;0;0;.00nan;0;0
4957;2777;80;0;0;0;0;.00nan;0;0
4957;2794;64;86;36;3;33;.917;3600000;0
4957;2922;64;0;0;0;0;.00nan;0;0
4957;2962;80;81;41;4;37;.902;3565150;0
4959;2510;69;26;24;6;18;.750;2637350;0
4959;2624;69;55;4;0;4;1.000;962650;0
4959;4931;70;0;0;0;0;.00nan;0;0
4959;5140;70;92;18;0;18;1.000;3600000;0
4961;2522;77;68;28;3;25;.893;3600000;0
4961;2532;66;38;22;5;17;.773;3529650;0
4961;2710;66;0;0;0;0;.00nan;0;0
4961;2752;77;0;0;0;0;.00nan;0;0
4963;2516;71;70;28;3;25;.893;3749350;0
4963;2598;73;0;0;0;0;.00nan;0;0
4963;2741;73;94;53;4;49;.925;3749350;0
4963;2968;71;0;0;0;0;.00nan;0;0
4965;2505;76;84;44;4;40;.909;3573200;0
4965;2616;83;0;0;0;0;.00nan;0;0
4965;2864;76;0;0;0;0;.00nan;0;0
4965;2967;83;94;36;2;34;.944;3600000;0
4967;2510;69;63;30;4;26;.867;3600000;0
4967;2616;83;100;44;1;43;.977;3600000;0
4967;2624;69;0;0;0;0;.00nan;0;0
4967;2967;83;0;0;0;0;.00nan;0;0
4969;2505;76;0;0;0;0;.00nan;0;0
4969;2531;68;0;0;0;0;.00nan;0;0
4969;2692;68;92;34;2;32;.941;3600000;0
4969;2864;76;65;31;4;27;.871;3525750;0
4971;2655;74;35;29;6;23;.793;2397750;0
4971;2708;74;52;8;1;7;.875;1202250;0
4971;2777;80;90;28;1;27;.964;3600000;0
4971;2962;80;0;0;0;0;.00nan;0;0
4973;2760;82;53;37;6;31;.838;2764500;0
4973;2771;82;41;2;1;1;.500;835500;0
4973;3013;85;65;19;2;17;.895;3600000;0
4973;3173;85;0;0;0;0;.00nan;0;0
4975;2522;77;0;0;0;0;.00nan;0;0
4975;2752;77;83;34;3;31;.912;3600000;0
4975;2883;78;0;0;0;0;.00nan;0;0
4975;2960;78;56;28;4;24;.857;3593250;0
4977;2593;81;42;26;5;21;.808;3600000;0
4977;2600;81;0;0;0;0;.00nan;0;0
4977;2672;79;0;0;0;0;.00nan;0;0
4977;2758;79;84;30;2;28;.933;3600000;0
4979;2794;64;59;6;0;6;1.000;1342150;0
4979;2922;64;14;17;6;11;.647;2257850;0
4979;4930;72;0;0;0;0;.00nan;0;0
4979;4962;72;48;16;3;13;.813;3600000;0
4981;2532;66;0;0;0;0;.00nan;0;0
4981;2710;66;94;18;0;18;1.000;3600000;0
4981;2773;75;69;29;3;26;.897;3600000;0
4981;5171;75;0;0;0;0;.00nan;0;0
4983;2476;67;34;4;2;2;.500;1241350;0
4983;2818;67;23;16;5;11;.688;2358650;0
4983;3187;84;0;0;0;0;.00nan;0;0
4983;3348;84;86;34;3;31;.912;3600000;0
4985;2541;65;93;36;2;34;.944;3600000;0
4985;2598;73;83;40;4;36;.900;3541450;0
4985;2741;73;0;0;0;0;.00nan;0;0
4985;2812;65;0;0;0;0;.00nan;0;0
4987;2516;71;0;0;0;0;.00nan;0;0
4987;2968;71;78;30;3;27;.900;3600000;0
4987;4931;70;0;0;0;0;.00nan;0;0
4987;5140;70;61;29;4;25;.862;3600000;0
4989;2505;76;59;30;4;26;.867;3510700;0
4989;2598;73;0;0;0;0;.00nan;0;0
4989;2741;73;100;42;2;40;.952;3600000;0
4989;2864;76;0;0;0;0;.00nan;0;0
4991;2777;80;0;0;0;0;.00nan;0;0
4991;2794;64;0;0;0;0;.00nan;0;0
4991;2922;64;100;28;0;28;1.000;3600000;0
4991;2962;80;55;34;5;29;.853;3600000;0
4993;2773;75;0;0;0;0;.00nan;0;0
4993;4930;72;54;26;4;22;.846;3542350;0
4993;4962;72;0;0;0;0;.00nan;0;0
4993;5171;75;84;31;2;29;.935;3600000;0
4995;2593;81;0;0;0;0;.00nan;0;0
4995;2600;81;91;29;1;28;.966;3600000;0
4995;4931;70;48;30;5;25;.833;3600000;0
4995;5140;70;0;0;0;0;.00nan;0;0
4997;2522;77;75;45;5;40;.889;3600000;0
4997;2532;66;100;23;0;23;1.000;3600000;0
4997;2710;66;0;0;0;0;.00nan;0;0
4997;2752;77;0;0;0;0;.00nan;0;0
4999;2476;67;49;30;5;25;.833;3600000;0
4999;2818;67;0;0;0;0;.00nan;0;0
4999;3013;85;0;0;0;0;.00nan;0;0
4999;3173;85;74;25;2;23;.920;3600000;0
5001;2616;83;0;0;0;0;.00nan;0;0
5001;2672;79;62;30;4;26;.867;3600000;0
5001;2758;79;0;0;0;0;.00nan;0;0
5001;2967;83;99;33;1;32;.970;3600000;0
5003;2510;69;61;7;0;7;1.000;1188300;0
5003;2516;71;67;31;4;27;.871;3600000;0
5003;2624;69;23;21;6;15;.714;2375200;0
5003;2968;71;0;0;0;0;.00nan;0;0
5005;2531;68;17;7;4;3;.429;1010950;0
5005;2655;74;0;0;0;0;.00nan;0;0
5005;2692;68;66;10;0;10;1.000;2589050;0
5005;2708;74;100;29;0;29;1.000;3600000;0
5007;2760;82;0;0;0;0;.00nan;0;0
5007;2771;82;64;33;4;29;.879;3600000;0
5007;3187;84;99;31;1;30;.968;3600000;0
5007;3348;84;0;0;0;0;.00nan;0;0
5009;2541;65;0;0;0;0;.00nan;0;0
5009;2812;65;91;40;3;37;.925;3600000;0
5009;2883;78;56;46;7;39;.848;3600000;0
5009;2960;78;0;0;0;0;.00nan;0;0
5011;2532;66;55;28;4;24;.857;2690150;0
5011;2710;66;30;14;4;10;.714;909850;0
5011;2777;80;59;22;3;19;.864;3600000;0
5011;2962;80;0;0;0;0;.00nan;0;0
5013;2598;73;88;31;2;29;.935;3600000;0
5013;2672;79;0;0;0;0;.00nan;0;0
5013;2741;73;0;0;0;0;.00nan;0;0
5013;2758;79;76;39;4;35;.897;3600000;0
5015;2522;77;0;0;0;0;.00nan;0;0
5015;2531;68;0;0;0;0;.00nan;0;0
5015;2692;68;91;17;0;17;1.000;3600000;0
5015;2752;77;73;33;4;29;.879;3600000;0
5017;2794;64;0;0;0;0;.00nan;0;0
5017;2922;64;79;39;4;35;.897;3600000;0
5017;4931;70;84;35;3;32;.914;3600000;0
5017;5140;70;0;0;0;0;.00nan;0;0
5019;2516;71;0;0;0;0;.00nan;0;0
5019;2760;82;70;28;3;25;.893;3568050;0
5019;2771;82;0;0;0;0;.00nan;0;0
5019;2968;71;100;33;1;32;.970;3600000;0
5021;2510;69;0;0;0;0;.00nan;0;0
5021;2541;65;35;35;7;28;.800;3600000;0
5021;2812;65;0;0;0;0;.00nan;0;0
5021;2845;69;88;33;2;31;.939;3600000;0
5023;2505;76;48;0;0;0;.00nan;318450;0
5023;2773;75;71;23;2;21;.913;3600000;0
5023;2864;76;26;30;7;23;.767;3281550;0
5023;5171;75;0;0;0;0;.00nan;0;0
5025;2593;81;57;41;6;35;.854;3563550;0
5025;2600;81;0;0;0;0;.00nan;0;0
5025;2616;83;71;40;5;35;.875;3600000;0
5025;2967;83;0;0;0;0;.00nan;0;0
5027;2476;67;0;0;0;0;.00nan;0;0
5027;2818;67;72;49;6;43;.878;3600000;0
5027;3013;85;57;27;4;23;.852;3600000;0
5027;3173;85;0;0;0;0;.00nan;0;0
5029;2883;78;0;0;0;0;.00nan;0;0
5029;2960;78;50;25;4;21;.840;3900000;0
5029;3187;84;0;0;0;0;.00nan;0;0
5029;3348;84;94;46;4;42;.913;3900000;0
5031;2655;74;0;0;0;0;.00nan;0;0
5031;2708;74;73;28;3;25;.893;3600000;0
5031;4930;72;0;0;0;0;.00nan;0;0
5031;4962;72;51;21;4;17;.810;3561100;0
5033;2541;65;0;0;0;0;.00nan;0;0
5033;2812;65;45;34;6;28;.824;3547500;0
5033;4931;70;0;0;0;0;.00nan;0;0
5033;5140;70;76;41;5;36;.878;3600000;0
5035;2672;79;97;20;0;20;1.000;3600000;0
5035;2758;79;0;0;0;0;.00nan;0;0
5035;2760;82;0;0;0;0;.00nan;0;0
5035;2771;82;75;33;3;30;.909;3600000;0
5037;2510;69;79;26;2;24;.923;3600000;0
5037;2655;74;56;20;3;17;.850;3583550;0
5037;2708;74;0;0;0;0;.00nan;0;0
5037;2845;69;0;0;0;0;.00nan;0;0
5039;2883;78;26;12;4;8;.667;1089900;0
5039;2960;78;55;10;1;9;.900;2510100;0
5039;3187;84;100;38;2;36;.947;3600000;0
5039;3348;84;0;0;0;0;.00nan;0;0
5041;2516;71;72;34;4;30;.882;3900000;0
5041;2968;71;0;0;0;0;.00nan;0;0
5041;4930;72;87;46;4;42;.913;3900000;0
5041;4962;72;0;0;0;0;.00nan;0;0
5043;2773;75;34;22;5;17;.773;3549100;0
5043;2794;64;91;45;3;42;.933;3600000;0
5043;2922;64;0;0;0;0;.00nan;0;0
5043;5171;75;0;0;0;0;.00nan;0;0
5045;2650;73;0;0;0;0;.00nan;0;0
5045;2741;73;63;42;6;36;.857;3600000;0
5045;2777;80;0;0;0;0;.00nan;0;0
5045;2962;80;56;20;3;17;.850;3600000;0
5047;2505;76;89;34;2;32;.941;3562350;0
5047;2531;68;0;0;0;0;.00nan;0;0
5047;2692;68;92;29;1;28;.966;3600000;0
5047;2864;76;0;0;0;0;.00nan;0;0
5049;2532;66;0;0;0;0;.00nan;0;0
5049;2710;66;31;24;6;18;.750;3600000;0
5049;3013;85;0;0;0;0;.00nan;0;0
5049;3173;85;100;25;0;25;1.000;3600000;0
5051;2476;67;68;21;2;19;.905;3600000;0
5051;2522;77;88;45;4;41;.911;3557800;0
5051;2752;77;0;0;0;0;.00nan;0;0
5051;2818;67;0;0;0;0;.00nan;0;0
5053;2593;81;0;0;0;0;.00nan;0;0
5053;2600;81;100;36;1;35;.972;3600000;0
5053;2616;83;0;0;0;0;.00nan;0;0
5053;2967;83;50;31;5;26;.839;3600000;0
3892;3537;122;0;0;0;0;.00nan;0;0
3892;3737;122;86;37;3;34;.919;3600000;0
3892;3754;117;77;40;4;36;.900;3548650;0
3892;3913;117;0;0;0;0;.00nan;0;0
3893;3546;121;0;0;0;0;.00nan;0;0
3893;3558;119;49;36;6;30;.833;3600000;0
3893;3716;119;0;0;0;0;.00nan;0;0
3893;3870;121;91;28;1;27;.964;3600000;0
3894;3692;118;0;0;0;0;.00nan;0;0
3894;3801;120;50;37;6;31;.838;3600000;0
3894;3898;118;75;32;3;29;.906;3600000;0
3894;4903;120;0;0;0;0;.00nan;0;0
3895;3602;113;0;0;0;0;.00nan;0;0
3895;3633;114;100;46;2;44;.957;3620450;0
3895;3882;113;64;24;3;21;.875;3620450;0
3895;3901;114;0;0;0;0;.00nan;0;0
3896;3514;123;100;41;2;39;.951;3600000;0
3896;3635;109;50;25;4;21;.840;3512550;0
3896;3676;123;0;0;0;0;.00nan;0;0
3896;5322;109;0;0;0;0;.00nan;0;0
3897;3513;108;74;31;3;28;.903;3900000;0
3897;3548;110;86;39;3;36;.923;3900000;0
3897;3596;108;0;0;0;0;.00nan;0;0
3897;3663;110;0;0;0;0;.00nan;0;0
3898;3512;116;83;24;1;23;.958;3600000;0
3898;3589;111;85;34;3;31;.912;3561550;0
3898;3613;116;0;0;0;0;.00nan;0;0
3898;3857;111;0;0;0;0;.00nan;0;0
3899;3580;112;50;18;3;15;.833;3548250;0
3899;3589;111;100;35;1;34;.971;3600000;0
3899;3712;112;0;0;0;0;.00nan;0;0
3899;3857;111;0;0;0;0;.00nan;0;0
3900;3530;107;0;0;0;0;.00nan;0;0
3900;3751;106;93;27;1;26;.963;3600000;0
3900;3906;106;0;0;0;0;.00nan;0;0
3900;3909;107;44;34;6;28;.824;3600000;0
3901;3548;110;54;33;5;28;.848;3600000;0
3901;3663;110;0;0;0;0;.00nan;0;0
3901;3887;115;91;28;1;27;.964;3600000;0
3901;3907;115;0;0;0;0;.00nan;0;0
3902;3546;121;68;34;4;30;.882;3556700;0
3902;3558;119;95;40;2;38;.950;3600000;0
3902;3716;119;0;0;0;0;.00nan;0;0
3902;3870;121;0;0;0;0;.00nan;0;0
3903;3692;118;79;27;2;25;.926;3632300;0
3903;3801;120;100;34;1;33;.971;3632300;0
3903;3898;118;0;0;0;0;.00nan;0;0
3903;4903;120;0;0;0;0;.00nan;0;0
3904;3537;122;89;32;2;30;.938;3600000;0
3904;3737;122;0;0;0;0;.00nan;0;0
3904;3754;117;85;37;3;34;.919;3554550;0
3904;3913;117;0;0;0;0;.00nan;0;0
3905;3580;112;93;40;3;37;.925;3740550;0
3905;3633;114;81;31;2;29;.935;3740550;0
3905;3712;112;0;0;0;0;.00nan;0;0
3905;3901;114;0;0;0;0;.00nan;0;0
3906;3513;108;79;47;5;42;.894;3600000;0
3906;3596;108;0;0;0;0;.00nan;0;0
3906;3887;115;0;0;0;0;.00nan;0;0
3906;3907;115;83;30;2;28;.933;3600000;0
3907;3530;107;51;18;3;15;.833;3600000;0
3907;3751;106;73;48;6;42;.875;3600000;0
3907;3906;106;0;0;0;0;.00nan;0;0
3907;3909;107;0;0;0;0;.00nan;0;0
3908;3512;116;0;0;0;0;.00nan;0;0
3908;3514;123;76;26;2;24;.923;3600000;0
3908;3613;116;32;39;8;31;.795;3600000;0
3908;3676;123;0;0;0;0;.00nan;0;0
3909;3602;113;46;11;2;9;.818;1095850;0
3909;3635;109;72;29;3;26;.897;3600000;0
3909;3882;113;52;38;6;32;.842;2504150;0
3909;5322;109;0;0;0;0;.00nan;0;0
3910;3546;121;0;0;0;0;.00nan;0;0
3910;3754;117;39;31;6;25;.806;2789100;0
3910;3870;121;88;27;1;26;.963;3600000;0
3910;3913;117;52;8;1;7;.875;810900;0
3911;3558;119;100;39;1;38;.974;3600000;0
3911;3692;118;28;24;6;18;.750;3600000;0
3911;3716;119;0;0;0;0;.00nan;0;0
3911;3898;118;0;0;0;0;.00nan;0;0
3912;3589;111;100;31;0;31;1.000;3600000;0
3912;3633;114;0;0;0;0;.00nan;0;0
3912;3857;111;0;0;0;0;.00nan;0;0
3912;3901;114;60;33;5;28;.848;3600000;0
3913;3514;123;63;32;4;28;.875;3600000;0
3913;3530;107;0;0;0;0;.00nan;0;0
3913;3676;123;0;0;0;0;.00nan;0;0
3913;3909;107;99;33;1;32;.970;3600000;0
3914;3751;106;0;0;0;0;.00nan;0;0
3914;3887;115;0;0;0;0;.00nan;0;0
3914;3906;106;86;39;3;36;.923;3737250;0
3914;3907;115;70;34;4;30;.882;3737250;0
3915;3512;116;86;39;3;36;.923;3575800;0
3915;3602;113;0;0;0;0;.00nan;0;0
3915;3613;116;0;0;0;0;.00nan;0;0
3915;3882;113;82;24;1;23;.958;3600000;0
3916;3548;110;0;0;0;0;.00nan;0;0
3916;3635;109;43;33;6;27;.818;3600000;0
3916;3663;110;100;40;2;38;.950;3600000;0
3916;5322;109;0;0;0;0;.00nan;0;0
3917;3513;108;0;0;0;0;.00nan;0;0
3917;3580;112;0;0;0;0;.00nan;0;0
3917;3596;108;84;31;2;29;.935;3600000;0
3917;3712;112;38;21;5;16;.762;3600000;0
3918;3589;111;100;42;1;41;.976;3600000;0
3918;3633;114;81;27;2;25;.926;3573200;0
3918;3857;111;0;0;0;0;.00nan;0;0
3918;3901;114;0;0;0;0;.00nan;0;0
3919;3514;123;0;0;0;0;.00nan;0;0
3919;3676;123;100;29;0;29;1.000;3600000;0
3919;3751;106;82;24;1;23;.958;3600000;0
3919;3906;106;0;0;0;0;.00nan;0;0
3920;3558;119;0;0;0;0;.00nan;0;0
3920;3716;119;67;15;1;14;.933;3600000;0
3920;3801;120;72;43;5;38;.884;3600000;0
3920;4903;120;0;0;0;0;.00nan;0;0
3921;3537;122;88;31;2;29;.935;3600000;0
3921;3692;118;69;35;4;31;.886;3558150;0
3921;3737;122;0;0;0;0;.00nan;0;0
3921;3898;118;0;0;0;0;.00nan;0;0
3922;3546;121;68;21;2;19;.905;3600000;0
3922;3754;117;77;16;0;16;1.000;1311400;0
3922;3870;121;0;0;0;0;.00nan;0;0
3922;3913;117;67;34;4;30;.882;2273700;0
3923;3530;107;68;35;4;31;.886;3546950;0
3923;3887;115;72;30;3;27;.900;3600000;0
3923;3907;115;0;0;0;0;.00nan;0;0
3923;3909;107;0;0;0;0;.00nan;0;0
3924;3537;122;89;54;5;49;.907;3828700;0
3924;3737;122;0;0;0;0;.00nan;0;0
3924;3801;120;0;0;0;0;.00nan;0;0
3924;4903;120;39;29;6;23;.793;3799100;0
3925;3548;110;87;40;3;37;.925;3706900;0
3925;3635;109;77;38;4;34;.895;3706900;0
3925;3663;110;0;0;0;0;.00nan;0;0
3925;5322;109;0;0;0;0;.00nan;0;0
3926;3512;116;0;0;0;0;.00nan;0;0
3926;3580;112;97;31;2;29;.935;3900000;0
3926;3613;116;86;34;2;32;.941;3900000;0
3926;3712;112;0;0;0;0;.00nan;0;0
3927;3513;108;99;39;2;37;.949;3600000;0
3927;3596;108;0;0;0;0;.00nan;0;0
3927;3602;113;71;37;4;33;.892;3579050;0
3927;3882;113;0;0;0;0;.00nan;0;0
3928;3537;122;63;25;3;22;.880;3113200;0
3928;3692;118;72;24;2;22;.917;3600000;0
3928;3737;122;30;8;3;5;.625;486800;0
3928;3898;118;0;0;0;0;.00nan;0;0
3929;3546;121;0;0;0;0;.00nan;0;0
3929;3801;120;72;30;3;27;.900;3600000;0
3929;3870;121;62;38;5;33;.868;3565900;0
3929;4903;120;0;0;0;0;.00nan;0;0
3930;3513;108;34;40;8;32;.800;3600000;0
3930;3596;108;0;0;0;0;.00nan;0;0
3930;3633;114;77;21;1;20;.952;3600000;0
3930;3901;114;0;0;0;0;.00nan;0;0
3931;3530;107;53;9;1;8;.889;1119400;0
3931;3635;109;66;38;5;33;.868;3600000;0
3931;3909;107;57;41;6;35;.854;2461650;0
3931;5322;109;0;0;0;0;.00nan;0;0
3932;3512;116;0;0;0;0;.00nan;0;0
3932;3589;111;0;0;0;0;.00nan;0;0
3932;3613;116;72;24;2;22;.917;3600000;0
3932;3857;111;54;37;6;31;.838;3600000;0
3933;3558;119;100;36;1;35;.972;3600000;0
3933;3602;113;0;0;0;0;.00nan;0;0
3933;3716;119;0;0;0;0;.00nan;0;0
3933;3882;113;80;35;3;32;.914;3515100;0
3934;3514;123;0;0;0;0;.00nan;0;0
3934;3530;107;98;48;3;45;.938;3600000;0
3934;3676;123;100;29;0;29;1.000;3600000;0
3934;3909;107;0;0;0;0;.00nan;0;0
3935;3537;122;72;31;3;28;.903;3730950;0
3935;3737;122;0;0;0;0;.00nan;0;0
3935;3754;117;85;50;4;46;.920;3730950;0
3935;3913;117;0;0;0;0;.00nan;0;0
3936;3513;108;0;0;0;0;.00nan;0;0
3936;3546;121;0;0;0;0;.00nan;0;0
3936;3596;108;73;24;2;22;.917;3600000;0
3936;3870;121;83;36;3;33;.917;3535300;0
3937;3602;113;84;36;3;33;.917;3694150;0
3937;3801;120;82;40;4;36;.900;3694150;0
3937;3882;113;0;0;0;0;.00nan;0;0
3937;4903;120;0;0;0;0;.00nan;0;0
3938;3580;112;57;34;5;29;.853;3600000;0
3938;3712;112;0;0;0;0;.00nan;0;0
3938;3751;106;0;0;0;0;.00nan;0;0
3938;3906;106;86;31;2;29;.935;3600000;0
3939;3589;111;58;26;4;22;.846;3600000;0
3939;3692;118;0;0;0;0;.00nan;0;0
3939;3857;111;0;0;0;0;.00nan;0;0
3939;3898;118;56;40;6;34;.850;3535750;0
3940;3548;110;0;0;0;0;.00nan;0;0
3940;3633;114;0;0;0;0;.00nan;0;0
3940;3663;110;66;25;3;22;.880;3785700;0
3940;3901;114;86;33;2;31;.939;3785700;0
3941;3512;116;27;24;6;18;.750;3005550;0
3941;3613;116;58;5;0;5;1.000;557200;0
3941;3887;115;0;0;0;0;.00nan;0;0
3941;3907;115;72;42;5;37;.881;3600000;0
3942;3514;123;74;50;6;44;.880;3341850;0
3942;3635;109;54;8;1;7;.875;1465650;0
3942;3676;123;56;4;0;4;1.000;226750;0
3942;5322;109;47;22;4;18;.818;2134350;0
3943;3580;112;0;0;0;0;.00nan;0;0
3943;3712;112;78;31;3;28;.903;3600000;0
3943;3751;106;53;26;4;22;.846;3592450;0
3943;3906;106;0;0;0;0;.00nan;0;0
3944;3512;116;0;0;0;0;.00nan;0;0
3944;3613;116;95;30;1;29;.967;3600000;0
3944;3692;118;67;28;3;25;.893;3527650;0
3944;3898;118;0;0;0;0;.00nan;0;0
3945;3530;107;0;0;0;0;.00nan;0;0
3945;3887;115;86;45;4;41;.911;3652050;0
3945;3907;115;0;0;0;0;.00nan;0;0
3945;3909;107;84;37;3;34;.919;3652050;0
3946;3513;108;74;25;2;23;.920;3600000;0
3946;3596;108;0;0;0;0;.00nan;0;0
3946;3801;120;0;0;0;0;.00nan;0;0
3946;4903;120;64;39;5;34;.872;3600000;0
3947;3558;119;89;16;0;16;1.000;3600000;0
3947;3716;119;0;0;0;0;.00nan;0;0
3947;3754;117;52;14;2;12;.857;1708650;0
3947;3913;117;28;25;6;19;.760;1891350;0
3948;3537;122;57;34;4;30;.882;3600000;0
3948;3633;114;66;23;1;22;.957;3600000;0
3948;3737;122;0;0;0;0;.00nan;0;0
3948;3901;114;0;0;0;0;.00nan;0;0
3949;3546;121;88;39;3;36;.923;3580000;0
3949;3602;113;0;0;0;0;.00nan;0;0
3949;3870;121;0;0;0;0;.00nan;0;0
3949;3882;113;51;16;2;14;.875;3600000;0
3950;3589;111;0;0;0;0;.00nan;0;0
3950;3635;109;68;28;2;26;.929;3900000;0
3950;3857;111;83;28;2;26;.929;3900000;0
3950;5322;109;0;0;0;0;.00nan;0;0
3951;3514;123;0;0;0;0;.00nan;0;0
3951;3548;110;62;31;3;28;.903;3562000;0
3951;3663;110;0;0;0;0;.00nan;0;0
3951;3676;123;69;20;2;18;.900;3600000;0
3952;3513;108;0;0;0;0;.00nan;0;0
3952;3558;119;79;27;1;26;.963;3600000;0
3952;3596;108;24;23;5;18;.783;3600000;0
3952;3716;119;0;0;0;0;.00nan;0;0
3953;3633;114;0;0;0;0;.00nan;0;0
3953;3692;118;82;30;2;28;.933;3700000;0
3953;3898;118;0;0;0;0;.00nan;0;0
3953;3901;114;73;32;3;29;.906;3700000;0
3954;3589;111;51;32;5;27;.844;3533000;0
3954;3635;109;0;0;0;0;.00nan;0;0
3954;3857;111;0;0;0;0;.00nan;0;0
3954;5322;109;62;25;3;22;.880;3600000;0
3955;3530;107;63;47;5;42;.894;3600000;0
3955;3751;106;0;0;0;0;.00nan;0;0
3955;3906;106;55;27;4;23;.852;3600000;0
3955;3909;107;0;0;0;0;.00nan;0;0
3956;3548;110;0;0;0;0;.00nan;0;0
3956;3663;110;75;48;6;42;.875;3600000;0
3956;3887;115;0;0;0;0;.00nan;0;0
3956;3907;115;65;23;3;20;.870;3600000;0
3957;3514;123;58;24;3;21;.875;3600000;0
3957;3558;119;47;34;5;29;.853;3539000;0
3957;3676;123;0;0;0;0;.00nan;0;0
3957;3716;119;0;0;0;0;.00nan;0;0
3958;3589;111;80;31;2;29;.935;3600000;0
3958;3801;120;59;29;3;26;.897;3554000;0
3958;3857;111;0;0;0;0;.00nan;0;0
3958;4903;120;0;0;0;0;.00nan;0;0
3959;3546;121;33;4;2;2;.500;862000;0
3959;3635;109;76;28;2;26;.929;3600000;0
3959;3870;121;42;28;6;22;.786;2738000;0
3959;5322;109;0;0;0;0;.00nan;0;0
3960;3513;108;58;27;3;24;.889;3560000;0
3960;3754;117;77;33;2;31;.939;3600000;0
3960;3906;108;0;0;0;0;.00nan;0;0
3960;3913;117;0;0;0;0;.00nan;0;0
3961;3548;110;49;28;4;24;.857;3595000;0
3961;3580;112;75;28;2;26;.929;3600000;0
3961;3663;110;0;0;0;0;.00nan;0;0
3961;3712;112;0;0;0;0;.00nan;0;0
3962;3514;123;0;0;0;0;.00nan;0;0
3962;3676;123;46;29;4;25;.862;3600000;0
3962;3692;118;0;0;0;0;.00nan;0;0
3962;3898;118;91;27;1;26;.963;3600000;0
3963;3537;122;0;0;0;0;.00nan;0;0
3963;3633;114;53;22;3;19;.864;3698000;0
3963;3737;122;83;48;4;44;.917;3734000;0
3963;3901;114;0;0;0;0;.00nan;0;0
3964;3580;112;0;0;0;0;.00nan;0;0
3964;3712;112;58;25;3;22;.880;3600000;0
3964;3887;115;0;0;0;0;.00nan;0;0
3964;3907;115;85;28;2;26;.929;3600000;0
3965;3602;113;0;0;0;0;.00nan;0;0
3965;3635;109;45;17;4;13;.765;3553000;0
3965;3882;113;79;29;2;27;.931;3600000;0
3965;5322;109;0;0;0;0;.00nan;0;0
3966;3512;116;36;32;5;27;.844;3562000;0
3966;3613;116;0;0;0;0;.00nan;0;0
3966;3801;120;0;0;0;0;.00nan;0;0
3966;4903;120;54;32;4;28;.875;3600000;0
3967;3514;123;79;36;2;34;.944;3900000;0
3967;3537;122;98;37;2;35;.946;3900000;0
3967;3676;123;0;0;0;0;.00nan;0;0
3967;3737;122;0;0;0;0;.00nan;0;0
3968;3751;106;82;39;4;35;.897;3900000;0
3968;3754;117;79;46;4;42;.913;3900000;0
3968;3913;117;0;0;0;0;.00nan;0;0
3968;4810;106;0;0;0;0;.00nan;0;0
3969;3548;110;0;0;0;0;.00nan;0;0
3969;3589;111;75;32;3;29;.906;3600000;0
3969;3663;110;32;27;5;22;.815;3551000;0
3969;3857;111;0;0;0;0;.00nan;0;0
3970;3558;119;38;23;5;18;.783;3600000;0
3970;3692;118;78;32;2;30;.938;3600000;0
3970;3716;119;0;0;0;0;.00nan;0;0
3970;3898;118;0;0;0;0;.00nan;0;0
3971;3530;107;0;0;0;0;.00nan;0;0
3971;3546;121;33;10;3;7;.700;560000;0
3971;3870;121;59;21;2;19;.905;3040000;0
3971;3909;107;72;28;2;26;.929;3600000;0
3972;3512;116;82;29;1;28;.966;3600000;0
3972;3580;112;67;30;3;27;.900;3569000;0
3972;3613;116;0;0;0;0;.00nan;0;0
3972;3712;112;0;0;0;0;.00nan;0;0
3973;3633;114;45;16;3;13;.813;3600000;0
3973;3801;120;34;33;6;27;.818;2217000;0
3973;3901;114;0;0;0;0;.00nan;0;0
3973;4903;120;43;14;3;11;.786;1383000;0
3974;3546;121;62;30;3;27;.900;3598000;0
3974;3751;106;0;0;0;0;.00nan;0;0
3974;3870;121;0;0;0;0;.00nan;0;0
3974;4810;106;73;25;2;23;.920;3600000;0
3975;3513;108;45;28;4;24;.857;3600000;0
3975;3635;109;81;27;1;26;.963;3600000;0
3975;3906;108;0;0;0;0;.00nan;0;0
3975;5322;109;0;0;0;0;.00nan;0;0
3976;3548;110;46;50;7;43;.860;3027000;0
3976;3663;110;49;1;0;1;1.000;573000;0
3976;3887;115;0;0;0;0;.00nan;0;0
3976;3907;115;83;34;2;32;.941;3600000;0
3977;3537;122;51;2;0;2;1.000;285000;0
3977;3558;119;0;0;0;0;.00nan;0;0
3977;3716;119;66;21;2;19;.905;3600000;0
3977;3737;122;41;36;6;30;.833;3315000;0
3978;3530;107;46;32;5;27;.844;3577000;0
3978;3754;117;0;0;0;0;.00nan;0;0
3978;3909;107;0;0;0;0;.00nan;0;0
3978;3913;117;60;27;3;24;.889;3600000;0
3979;3589;111;0;0;0;0;.00nan;0;0
3979;3602;113;41;34;6;28;.824;3572000;0
3979;3857;111;52;24;4;20;.833;3600000;0
3979;3882;113;0;0;0;0;.00nan;0;0
3980;3513;108;60;45;5;40;.889;3600000;0
3980;3580;112;17;27;6;21;.778;3578000;0
3980;3712;112;0;0;0;0;.00nan;0;0
3980;3906;108;0;0;0;0;.00nan;0;0
3981;3635;109;99;30;1;29;.967;3600000;0
3981;3887;115;70;48;5;43;.896;3600000;0
3981;3907;115;0;0;0;0;.00nan;0;0
3981;5322;109;0;0;0;0;.00nan;0;0
3982;3537;122;67;26;3;23;.885;3900000;0
3982;3546;121;0;0;0;0;.00nan;0;0
3982;3737;122;0;0;0;0;.00nan;0;0
3982;3870;121;76;40;3;37;.925;3900000;0
3983;3530;107;43;34;5;29;.853;3600000;0
3983;3692;118;63;22;2;20;.909;3600000;0
3983;3898;118;0;0;0;0;.00nan;0;0
3983;3909;107;0;0;0;0;.00nan;0;0
3984;3514;123;0;0;0;0;.00nan;0;0
3984;3602;113;0;0;0;0;.00nan;0;0
3984;3676;123;34;26;5;21;.808;3679000;0
3984;3882;113;78;36;4;32;.889;3679000;0
3985;3512;116;0;0;0;0;.00nan;0;0
3985;3613;116;82;26;1;25;.962;3600000;0
3985;3633;114;47;19;3;16;.842;3528000;0
3985;3901;114;0;0;0;0;.00nan;0;0
3986;3546;121;51;33;5;28;.848;3600000;0
3986;3751;106;62;20;2;18;.900;3600000;0
3986;3870;121;0;0;0;0;.00nan;0;0
3986;4810;106;0;0;0;0;.00nan;0;0
3987;3530;107;80;35;2;33;.943;2437000;0
3987;3801;120;65;29;2;27;.931;3600000;0
3987;3909;107;25;12;4;8;.667;1163000;0
3987;4903;120;0;0;0;0;.00nan;0;0
3988;3580;112;26;32;6;26;.813;3768000;0
3988;3633;114;0;0;0;0;.00nan;0;0
3988;3712;112;0;0;0;0;.00nan;0;0
3988;3901;114;64;36;5;31;.861;3768000;0
3989;3589;111;35;34;6;28;.824;3600000;0
3989;3857;111;0;0;0;0;.00nan;0;0
3989;3887;115;0;0;0;0;.00nan;0;0
3989;3907;115;62;28;3;25;.893;3600000;0
3990;3548;110;0;0;0;0;.00nan;0;0
3990;3635;109;0;0;0;0;.00nan;0;0
3990;3663;110;91;43;2;41;.953;3600000;0
3990;5322;109;71;43;4;39;.907;3588000;0
3991;3513;108;26;36;7;29;.806;3336000;0
3991;3514;123;50;19;3;16;.842;3600000;0
3991;3676;123;0;0;0;0;.00nan;0;0
3991;3906;108;51;2;0;2;1.000;264000;0
3992;3537;122;61;38;5;33;.868;3530000;0
3992;3692;118;70;33;3;30;.909;3600000;0
3992;3737;122;0;0;0;0;.00nan;0;0
3992;3898;118;0;0;0;0;.00nan;0;0
3993;3580;112;0;0;0;0;.00nan;0;0
3993;3602;113;0;0;0;0;.00nan;0;0
3993;3712;112;47;22;3;19;.864;3600000;0
3993;3882;113;56;18;2;16;.889;3600000;0
3994;3512;116;0;0;0;0;.00nan;0;0
3994;3613;116;91;31;1;30;.968;3600000;0
3994;3887;115;46;26;4;22;.846;3600000;0
3994;3907;115;0;0;0;0;.00nan;0;0
3995;3751;106;0;0;0;0;.00nan;0;0
3995;3801;120;0;0;0;0;.00nan;0;0
3995;4810;106;39;23;4;19;.826;3717000;0
3995;4903;120;56;29;3;26;.897;3717000;0
3996;3558;119;100;35;0;35;1.000;3600000;0
3996;3716;119;0;0;0;0;.00nan;0;0
3996;3754;117;74;36;3;33;.917;3600000;0
3996;3913;117;0;0;0;0;.00nan;0;0
3997;3530;107;52;16;2;14;.875;3600000;0
3997;3546;121;45;32;5;27;.844;3092000;0
3997;3870;121;31;15;4;11;.733;508000;0
3997;3909;107;0;0;0;0;.00nan;0;0
3998;3537;122;0;0;0;0;.00nan;0;0
3998;3737;122;65;33;4;29;.879;3600000;0
3998;3754;117;0;0;0;0;.00nan;0;0
3998;3913;117;64;35;5;30;.857;3587000;0
3999;3513;108;45;21;3;18;.857;3546000;0
3999;3635;109;71;23;1;22;.957;3600000;0
3999;3906;108;0;0;0;0;.00nan;0;0
3999;5322;109;0;0;0;0;.00nan;0;0
4000;3558;119;33;14;4;10;.714;832000;0
4000;3716;119;65;26;2;24;.923;2737000;0
4000;3751;106;39;24;5;19;.792;3600000;0
4000;4810;106;0;0;0;0;.00nan;0;0
4001;3512;116;52;34;5;29;.853;3600000;0
4001;3589;111;86;36;2;34;.944;3600000;0
4001;3613;116;0;0;0;0;.00nan;0;0
4001;3857;111;0;0;0;0;.00nan;0;0
4002;3514;123;0;0;0;0;.00nan;0;0
4002;3548;110;62;30;3;27;.900;3573000;0
4002;3663;110;0;0;0;0;.00nan;0;0
4002;3676;123;88;32;2;30;.938;3600000;0
4003;3602;113;67;21;2;19;.905;3600000;0
4003;3633;114;60;29;4;25;.862;3518000;0
4003;3882;113;0;0;0;0;.00nan;0;0
4003;3901;114;0;0;0;0;.00nan;0;0
4004;3558;119;75;25;2;23;.920;3600000;0
4004;3716;119;0;0;0;0;.00nan;0;0
4004;3801;120;42;35;6;29;.829;3600000;0
4004;4903;120;0;0;0;0;.00nan;0;0
4005;3589;111;0;0;0;0;.00nan;0;0
4005;3602;113;0;0;0;0;.00nan;0;0
4005;3857;111;54;28;3;25;.893;3759000;0
4005;3882;113;53;28;4;24;.857;3759000;0
4006;3512;116;61;27;3;24;.889;3414000;0
4006;3613;116;23;4;3;1;.250;186000;0
4006;3633;114;91;31;1;30;.968;3600000;0
4006;3901;114;0;0;0;0;.00nan;0;0
4007;3676;118;0;0;0;0;.00nan;0;0
4007;3692;118;42;29;6;23;.793;3600000;0
4007;3754;117;22;34;7;27;.794;3600000;0
4007;3913;117;0;0;0;0;.00nan;0;0
4008;3514;123;0;0;0;0;.00nan;0;0
4008;3546;121;17;23;6;17;.739;2943000;0
4008;3870;121;71;12;0;12;1.000;657000;0
4008;3898;123;80;25;1;24;.960;3600000;0
4009;3558;119;28;30;6;24;.800;3570000;0
4009;3716;119;0;0;0;0;.00nan;0;0
4009;3754;117;0;0;0;0;.00nan;0;0
4009;3913;117;38;28;5;23;.821;3600000;0
4010;3537;122;0;0;0;0;.00nan;0;0
4010;3580;112;63;29;4;25;.862;3785000;0
4010;3712;112;0;0;0;0;.00nan;0;0
4010;3737;122;87;39;3;36;.923;3785000;0
4011;3676;118;71;26;2;24;.923;3600000;0
4011;3692;118;0;0;0;0;.00nan;0;0
4011;3801;120;72;45;3;42;.933;3550000;0
4011;4903;120;0;0;0;0;.00nan;0;0
4012;3589;111;42;33;6;27;.818;2498000;0
4012;3633;114;98;21;0;21;1.000;3600000;0
4012;3857;111;70;14;0;14;1.000;1102000;0
4012;3901;114;0;0;0;0;.00nan;0;0
4013;3530;107;50;33;5;28;.848;3600000;0
4013;3635;109;99;28;0;28;1.000;3600000;0
4013;3909;107;0;0;0;0;.00nan;0;0
4013;5322;109;0;0;0;0;.00nan;0;0
4014;3602;113;0;0;0;0;.00nan;0;0
4014;3882;113;91;35;2;33;.943;3600000;0
4014;3887;115;43;19;3;16;.842;697000;0
4014;3907;115;39;39;6;33;.846;2903000;0
4015;3546;121;46;31;5;26;.839;3164000;0
4015;3548;110;94;24;0;24;1.000;3600000;0
4015;3663;110;0;0;0;0;.00nan;0;0
4015;3870;121;33;10;3;7;.700;436000;0
4016;3512;116;71;28;2;26;.929;3600000;0
4016;3513;108;53;27;4;23;.852;3577000;0
4016;3613;116;0;0;0;0;.00nan;0;0
4016;3906;108;0;0;0;0;.00nan;0;0
4017;3537;122;86;49;4;45;.918;3600000;0
4017;3737;122;0;0;0;0;.00nan;0;0
4017;3801;120;0;0;0;0;.00nan;0;0
4017;4903;120;37;27;5;22;.815;3595000;0
4018;3589;111;0;0;0;0;.00nan;0;0
4018;3633;114;60;27;3;24;.889;3900000;0
4018;3857;111;66;27;3;24;.889;3900000;0
4018;3901;114;0;0;0;0;.00nan;0;0
4019;3635;109;52;36;4;32;.889;3900000;0
4019;3751;106;58;27;4;23;.852;3900000;0
4019;4810;106;0;0;0;0;.00nan;0;0
4019;5322;109;0;0;0;0;.00nan;0;0
4020;3513;108;0;0;0;0;.00nan;0;0
4020;3546;121;0;0;0;0;.00nan;0;0
4020;3870;121;52;29;4;25;.862;3900000;0
4020;3906;108;61;34;4;30;.882;3900000;0
4021;3602;113;40;37;6;31;.838;3600000;0
4021;3882;113;0;0;0;0;.00nan;0;0
4021;3887;115;64;28;3;25;.893;3600000;0
4021;3907;115;0;0;0;0;.00nan;0;0
4022;3512;116;0;0;0;0;.00nan;0;0
4022;3548;110;70;38;4;34;.895;3544000;0
4022;3613;116;58;20;2;18;.900;3600000;0
4022;3663;110;0;0;0;0;.00nan;0;0
4023;3558;119;0;0;0;0;.00nan;0;0
4023;3580;112;41;11;2;9;.818;1302000;0
4023;3712;112;11;15;6;9;.600;2298000;0
4023;3716;119;83;40;2;38;.950;3600000;0
4024;3514;123;33;36;7;29;.806;3600000;0
4024;3530;107;0;0;0;0;.00nan;0;0
4024;3898;123;0;0;0;0;.00nan;0;0
4024;3909;107;60;34;4;30;.882;3600000;0
4025;3580;112;45;19;3;16;.842;3569000;0
4025;3712;112;0;0;0;0;.00nan;0;0
4025;3754;117;62;21;2;19;.905;3600000;0
4025;3913;117;0;0;0;0;.00nan;0;0
4026;3514;123;0;0;0;0;.00nan;0;0
4026;3751;106;67;26;2;24;.923;3002000;0
4026;3898;123;66;22;2;20;.909;3600000;0
4026;4810;106;16;9;4;5;.556;598000;0
4027;3537;122;63;32;4;28;.875;3600000;0
4027;3737;122;0;0;0;0;.00nan;0;0
4027;3801;120;39;33;6;27;.818;3551000;0
4027;4903;120;0;0;0;0;.00nan;0;0
4028;3635;109;70;43;5;38;.884;3600000;0
4028;3676;118;73;20;1;19;.950;3600000;0
4028;3692;118;0;0;0;0;.00nan;0;0
4028;5322;109;0;0;0;0;.00nan;0;0
4029;3558;119;70;41;5;36;.878;3600000;0
4029;3716;119;0;0;0;0;.00nan;0;0
4029;3751;106;41;17;3;14;.824;3600000;0
4029;4810;106;0;0;0;0;.00nan;0;0
4030;3589;111;0;0;0;0;.00nan;0;0
4030;3857;111;97;27;1;26;.963;3900000;0
4030;3887;115;0;0;0;0;.00nan;0;0
4030;3907;115;97;29;1;28;.966;3900000;0
4031;3512;116;0;0;0;0;.00nan;0;0
4031;3513;108;54;37;5;32;.865;3600000;0
4031;3613;116;90;21;0;21;1.000;3600000;0
4031;3906;108;0;0;0;0;.00nan;0;0
4032;3546;121;0;0;0;0;.00nan;0;0
4032;3548;110;65;48;5;43;.896;3570000;0
4032;3663;110;0;0;0;0;.00nan;0;0
4032;3870;121;36;17;4;13;.765;3600000;0
4033;3530;107;100;25;0;25;1.000;3600000;0
4033;3558;119;0;0;0;0;.00nan;0;0
4033;3716;119;61;42;5;37;.881;3600000;0
4033;3909;107;0;0;0;0;.00nan;0;0
4034;3633;114;92;35;2;33;.943;3600000;0
4034;3801;120;41;35;6;29;.829;3600000;0
4034;3901;114;0;0;0;0;.00nan;0;0
4034;4903;120;0;0;0;0;.00nan;0;0
4035;3537;122;72;42;4;38;.905;3557000;0
4035;3737;122;0;0;0;0;.00nan;0;0
4035;3754;117;71;31;2;29;.935;3600000;0
4035;3913;117;0;0;0;0;.00nan;0;0
4036;3580;112;57;28;3;25;.893;3600000;0
4036;3712;112;0;0;0;0;.00nan;0;0
4036;3887;115;62;28;4;24;.857;2881000;0
4036;3907;115;21;11;4;7;.636;719000;0
4037;3530;107;87;26;1;25;.962;3900000;0
4037;3676;118;0;0;0;0;.00nan;0;0
4037;3692;118;83;27;1;26;.963;3900000;0
4037;3909;107;0;0;0;0;.00nan;0;0
4038;3514;123;0;0;0;0;.00nan;0;0
4038;3602;113;0;0;0;0;.00nan;0;0
4038;3882;113;32;25;5;20;.800;3518000;0
4038;3898;123;61;23;3;20;.870;3600000;0
4039;3513;108;49;23;3;20;.870;3600000;0
4039;3589;111;19;16;5;11;.688;905000;0
4039;3857;111;56;27;4;23;.852;2695000;0
4039;3906;108;0;0;0;0;.00nan;0;0
4040;3537;122;0;0;0;0;.00nan;0;0
4040;3737;122;45;28;5;23;.821;3600000;0
4040;3754;117;0;0;0;0;.00nan;0;0
4040;3913;117;85;29;1;28;.966;3600000;0
4041;3512;116;0;0;0;0;.00nan;0;0
4041;3602;113;39;28;5;23;.821;3579000;0
4041;3613;116;62;32;4;28;.875;3600000;0
4041;3882;113;0;0;0;0;.00nan;0;0
4042;3558;119;55;30;4;26;.867;3600000;0
4042;3635;109;23;12;4;8;.667;1130000;0
4042;3716;119;0;0;0;0;.00nan;0;0
4042;5322;109;38;17;3;14;.824;2470000;0
4043;3676;118;32;32;6;26;.813;3274000;0
4043;3692;118;43;5;1;4;.800;326000;0
4043;3751;106;67;35;3;32;.914;3600000;0
4043;4810;106;0;0;0;0;.00nan;0;0
4044;3513;108;48;6;1;5;.833;971000;0
4044;3589;111;22;24;6;18;.750;2741000;0
4044;3857;111;47;4;1;3;.750;1159000;0
4044;3906;108;20;21;6;15;.714;2929000;0
4045;3514;123;42;25;4;21;.840;3600000;0
4045;3887;115;0;0;0;0;.00nan;0;0
4045;3898;123;0;0;0;0;.00nan;0;0
4045;3907;115;55;42;5;37;.881;3563000;0
4046;3548;110;93;39;2;37;.949;3900000;0
4046;3663;110;0;0;0;0;.00nan;0;0
4046;3801;120;71;36;2;34;.944;3900000;0
4046;4903;120;0;0;0;0;.00nan;0;0
4047;3546;121;63;29;3;26;.897;3600000;0
4047;3633;114;53;32;4;28;.875;3548000;0
4047;3870;121;0;0;0;0;.00nan;0;0
4047;3901;114;0;0;0;0;.00nan;0;0
4048;3548;110;0;0;0;0;.00nan;0;0
4048;3663;110;43;26;4;22;.846;3566000;0
4048;3754;117;76;27;2;25;.926;3600000;0
4048;3913;117;0;0;0;0;.00nan;0;0
4049;3512;116;0;0;0;0;.00nan;0;0
4049;3580;112;45;39;6;33;.846;3600000;0
4049;3613;116;73;22;1;21;.955;3600000;0
4049;3712;112;0;0;0;0;.00nan;0;0
4050;3530;107;83;23;1;22;.957;3600000;0
4050;3580;112;26;32;6;26;.813;3600000;0
4050;3712;112;0;0;0;0;.00nan;0;0
4050;3909;107;0;0;0;0;.00nan;0;0
4051;3512;116;51;33;5;28;.848;3580000;0
4051;3589;111;66;34;3;31;.912;3600000;0
4051;3613;116;0;0;0;0;.00nan;0;0
4051;3857;111;0;0;0;0;.00nan;0;0
4052;3514;123;96;32;0;32;1.000;3009000;0
4052;3633;114;0;0;0;0;.00nan;0;0
4052;3898;123;27;7;3;4;.571;547000;0
4052;3901;114;47;10;2;8;.800;3600000;0
4053;3558;119;49;36;5;31;.861;3536000;0
4053;3676;118;63;26;3;23;.885;3600000;0
4053;3692;118;0;0;0;0;.00nan;0;0
4053;3716;119;0;0;0;0;.00nan;0;0
4054;3546;121;0;0;0;0;.00nan;0;0
4054;3870;121;77;27;1;26;.963;3600000;0
4054;3887;115;89;39;2;37;.949;3592000;0
4054;3907;115;0;0;0;0;.00nan;0;0
4055;3754;117;60;28;3;25;.893;3600000;0
4055;3801;120;78;27;2;25;.926;3600000;0
4055;3913;117;0;0;0;0;.00nan;0;0
4055;4903;120;0;0;0;0;.00nan;0;0
4056;3530;107;37;26;6;20;.769;2721000;0
4056;3633;114;15;22;6;16;.727;3600000;0
4056;3901;114;0;0;0;0;.00nan;0;0
4056;3909;107;53;10;1;9;.900;835000;0
4057;3580;112;59;27;4;23;.852;3893000;0
4057;3635;109;71;43;4;39;.907;3900000;0
4057;3712;112;0;0;0;0;.00nan;0;0
4057;5322;109;0;0;0;0;.00nan;0;0
4058;3514;123;62;21;2;19;.905;3900000;0
4058;3589;111;71;26;2;24;.923;3900000;0
4058;3857;111;0;0;0;0;.00nan;0;0
4058;3898;123;0;0;0;0;.00nan;0;0
4059;3548;110;48;37;5;32;.865;3600000;0
4059;3602;113;0;0;0;0;.00nan;0;0
4059;3663;110;0;0;0;0;.00nan;0;0
4059;3882;113;84;24;1;23;.958;3600000;0
4060;3512;116;0;0;0;0;.00nan;0;0
4060;3613;116;95;45;1;44;.978;3600000;0
4060;3751;106;49;19;3;16;.842;3519000;0
4060;4810;106;0;0;0;0;.00nan;0;0
4061;3513;108;70;40;4;36;.900;3552000;0
4061;3537;122;80;35;3;32;.914;3600000;0
4061;3737;122;0;0;0;0;.00nan;0;0
4061;3906;108;0;0;0;0;.00nan;0;0
4062;3512;116;65;36;4;32;.889;3600000;0
4062;3613;116;0;0;0;0;.00nan;0;0
4062;3751;106;23;28;6;22;.786;3522000;0
4062;4810;106;0;0;0;0;.00nan;0;0
4063;3530;107;86;52;2;50;.962;3900000;0
4063;3633;114;0;0;0;0;.00nan;0;0
4063;3901;114;62;17;2;15;.882;3900000;0
4063;3909;107;0;0;0;0;.00nan;0;0
4064;3580;112;0;0;0;0;.00nan;0;0
4064;3635;109;0;0;0;0;.00nan;0;0
4064;3712;112;28;15;4;11;.733;3560000;0
4064;5322;109;84;33;2;31;.939;3600000;0
4065;3537;122;60;24;2;22;.917;2709000;0
4065;3602;113;39;16;4;12;.750;3600000;0
4065;3737;122;22;9;4;5;.556;848000;0
4065;3882;113;0;0;0;0;.00nan;0;0
4066;3513;108;0;0;0;0;.00nan;0;0
4066;3514;123;46;6;1;5;.833;869000;0
4066;3898;123;29;27;6;21;.778;2731000;0
4066;3906;108;75;26;1;25;.962;3600000;0
4067;3801;120;0;0;0;0;.00nan;0;0
4067;3887;115;0;0;0;0;.00nan;0;0
4067;3907;115;82;30;2;28;.933;3600000;0
4067;4903;120;46;39;6;33;.846;3600000;0
4068;3546;121;0;0;0;0;.00nan;0;0
4068;3801;120;95;46;2;44;.957;3575000;0
4068;3870;121;81;25;1;24;.960;3600000;0
4068;4903;120;0;0;0;0;.00nan;0;0
4069;3676;118;70;33;3;30;.909;3548000;0
4069;3692;118;0;0;0;0;.00nan;0;0
4069;3754;117;81;33;2;31;.939;3600000;0
4069;3913;117;0;0;0;0;.00nan;0;0
4070;3513;108;45;34;5;29;.853;3600000;0
4070;3635;109;66;20;2;18;.900;3600000;0
4070;3906;108;0;0;0;0;.00nan;0;0
4070;5322;109;0;0;0;0;.00nan;0;0
4071;3537;122;0;0;0;0;.00nan;0;0
4071;3548;110;0;0;0;0;.00nan;0;0
4071;3663;110;94;31;2;29;.935;3600000;0
4071;3737;122;56;51;6;45;.882;3600000;0
4072;3558;119;84;30;2;28;.933;3600000;0
4072;3716;119;0;0;0;0;.00nan;0;0
4072;3887;115;49;26;4;22;.846;3600000;0
4072;3907;115;0;0;0;0;.00nan;0;0
4073;3589;111;0;0;0;0;.00nan;0;0
4073;3751;106;61;7;0;7;1.000;314000;0
4073;3857;111;89;18;0;18;1.000;3600000;0
4073;4810;106;33;30;6;24;.800;3286000;0
4074;3546;121;31;14;4;10;.714;1168000;0
4074;3754;117;0;0;0;0;.00nan;0;0
4074;3870;121;49;29;4;25;.862;2432000;0
4074;3913;117;58;33;4;29;.879;3600000;0
4075;3546;121;69;41;5;36;.878;3578000;0
4075;3676;118;48;16;3;13;.813;3600000;0
4075;3692;118;0;0;0;0;.00nan;0;0
4075;3870;121;0;0;0;0;.00nan;0;0
5055;3530;107;0;0;0;0;.00nan;0;0
5055;3537;122;76;44;5;39;.886;3600000;0
5055;3737;122;0;0;0;0;.00nan;0;0
5055;3909;107;95;37;2;35;.946;3600000;0
5057;3558;119;70;23;2;21;.913;3600000;0
5057;3716;119;0;0;0;0;.00nan;0;0
5057;3887;115;66;46;6;40;.870;3600000;0
5057;3907;115;0;0;0;0;.00nan;0;0
5059;3548;110;89;34;2;32;.941;3600000;0
5059;3580;112;100;37;1;36;.973;3600000;0
5059;3663;110;0;0;0;0;.00nan;0;0
5059;3712;112;0;0;0;0;.00nan;0;0
5061;3513;108;68;40;5;35;.875;3600000;0
5061;3546;121;83;29;2;27;.931;3600000;0
5061;3596;108;0;0;0;0;.00nan;0;0
5061;3870;121;0;0;0;0;.00nan;0;0
5063;3635;109;86;44;4;40;.909;3600000;0
5063;3692;118;52;32;5;27;.844;3590450;0
5063;3711;109;0;0;0;0;.00nan;0;0
5063;3898;118;0;0;0;0;.00nan;0;0
5065;3512;116;73;31;3;28;.903;3572000;0
5065;3602;113;95;43;1;42;.977;3600000;0
5065;3613;116;0;0;0;0;.00nan;0;0
5065;3882;113;0;0;0;0;.00nan;0;0
5067;3589;111;32;26;6;20;.769;3600000;0
5067;3751;106;93;29;1;28;.966;3600000;0
5067;3857;111;0;0;0;0;.00nan;0;0
5067;3906;106;0;0;0;0;.00nan;0;0
5069;3633;114;20;19;6;13;.684;2283800;0
5069;3722;120;0;0;0;0;.00nan;0;0
5069;3801;120;100;29;0;29;1.000;3600000;0
5069;3901;114;48;5;1;4;.800;1316200;0
5071;3514;123;38;24;5;19;.792;3600000;0
5071;3676;123;0;0;0;0;.00nan;0;0
5071;3754;117;100;34;1;33;.971;3600000;0
5071;3913;117;0;0;0;0;.00nan;0;0
5073;3722;120;0;0;0;0;.00nan;0;0
5073;3754;117;61;36;5;31;.861;3600000;0
5073;3801;120;70;23;2;21;.913;3600000;0
5073;3913;117;0;0;0;0;.00nan;0;0
5075;3537;122;0;0;0;0;.00nan;0;0
5075;3635;109;80;45;5;40;.889;3657300;0
5075;3711;109;0;0;0;0;.00nan;0;0
5075;3737;122;88;45;4;41;.911;3657300;0
5077;3602;113;52;26;4;22;.846;3600000;0
5077;3633;114;85;24;1;23;.958;3600000;0
5077;3882;113;0;0;0;0;.00nan;0;0
5077;3901;114;0;0;0;0;.00nan;0;0
5079;3558;119;68;39;5;34;.872;3719400;0
5079;3580;112;55;28;4;24;.857;3719400;0
5079;3712;112;0;0;0;0;.00nan;0;0
5079;3716;119;0;0;0;0;.00nan;0;0
5081;3514;123;0;0;0;0;.00nan;0;0
5081;3546;121;0;0;0;0;.00nan;0;0
5081;3676;123;48;29;5;24;.828;3600000;0
5081;3870;121;100;53;2;51;.962;3600000;0
5083;3513;108;0;0;0;0;.00nan;0;0
5083;3548;110;0;0;0;0;.00nan;0;0
5083;3596;108;70;24;2;22;.917;3575000;0
5083;3663;110;100;47;0;47;1.000;3600000;0
5085;3530;107;0;0;0;0;.00nan;0;0
5085;3751;106;49;36;6;30;.833;3600000;0
5085;3906;106;0;0;0;0;.00nan;0;0
5085;3909;107;54;20;3;17;.850;3600000;0
5087;3512;116;0;0;0;0;.00nan;0;0
5087;3613;116;100;41;1;40;.976;3600000;0
5087;3692;118;61;25;3;22;.880;3554700;0
5087;3898;118;0;0;0;0;.00nan;0;0
5089;3589;111;54;25;4;21;.840;3600000;0
5089;3857;111;0;0;0;0;.00nan;0;0
5089;3887;115;56;40;6;34;.850;3585350;0
5089;3907;115;0;0;0;0;.00nan;0;0
5091;3580;112;0;0;0;0;.00nan;0;0
5091;3712;112;79;22;1;21;.955;3600000;0
5091;3722;120;88;34;2;32;.941;3551000;0
5091;3801;120;0;0;0;0;.00nan;0;0
5093;3530;107;55;27;4;23;.852;3600000;0
5093;3635;109;0;0;0;0;.00nan;0;0
5093;3711;109;94;43;3;40;.930;3600000;0
5093;3909;107;0;0;0;0;.00nan;0;0
5095;3602;113;0;0;0;0;.00nan;0;0
5095;3754;117;0;0;0;0;.00nan;0;0
5095;3882;113;50;31;5;26;.839;3600000;0
5095;3913;117;81;35;3;32;.914;3600000;0
5097;3513;108;55;34;5;29;.853;3600000;0
5097;3548;110;0;0;0;0;.00nan;0;0
5097;3596;108;0;0;0;0;.00nan;0;0
5097;3663;110;86;32;2;30;.938;3600000;0
5099;3589;111;0;0;0;0;.00nan;0;0
5099;3857;111;100;37;1;36;.973;3600000;0
5099;3887;115;0;0;0;0;.00nan;0;0
5099;3907;115;70;36;4;32;.889;3600000;0
5101;3558;119;100;22;0;22;1.000;3600000;0
5101;3716;119;0;0;0;0;.00nan;0;0
5101;3751;106;0;0;0;0;.00nan;0;0
5101;3906;106;68;34;4;30;.882;3600000;0
5103;3512;116;50;19;3;16;.842;3541650;0
5103;3613;116;0;0;0;0;.00nan;0;0
5103;3633;114;0;0;0;0;.00nan;0;0
5103;3901;114;79;26;2;24;.923;3600000;0
5105;3546;121;32;27;6;21;.778;2703850;0
5105;3692;118;0;0;0;0;.00nan;0;0
5105;3870;121;46;5;1;4;.800;896150;0
5105;3898;118;84;25;1;24;.960;3600000;0
5107;3514;123;83;36;3;33;.917;3600000;0
5107;3537;122;49;36;6;30;.833;3219100;0
5107;3676;123;0;0;0;0;.00nan;0;0
5107;3737;122;50;1;0;1;1.000;380900;0
5109;3512;116;0;0;0;0;.00nan;0;0
5109;3513;108;0;0;0;0;.00nan;0;0
5109;3596;108;51;30;5;25;.833;3900000;0
5109;3613;116;57;34;5;29;.853;3900000;0
5111;3558;119;76;20;1;19;.950;3600000;0
5111;3633;114;25;23;6;17;.739;2322350;0
5111;3716;119;0;0;0;0;.00nan;0;0
5111;3901;114;55;4;0;4;1.000;1277650;0
5113;3530;107;0;0;0;0;.00nan;0;0
5113;3537;122;100;39;1;38;.974;3900000;0
5113;3737;122;0;0;0;0;.00nan;0;0
5113;3909;107;72;19;1;18;.947;3900000;0
5115;3546;121;0;0;0;0;.00nan;0;0
5115;3754;117;38;30;6;24;.800;3590000;0
5115;3870;121;61;36;5;31;.861;3600000;0
5115;3913;117;0;0;0;0;.00nan;0;0
5117;3514;123;0;0;0;0;.00nan;0;0
5117;3589;111;72;40;5;35;.875;3578700;0
5117;3676;123;82;36;3;33;.917;3600000;0
5117;3857;111;0;0;0;0;.00nan;0;0
5119;3580;112;66;34;4;30;.882;3600000;0
5119;3712;112;0;0;0;0;.00nan;0;0
5119;3751;106;100;22;0;22;1.000;3600000;0
5119;3906;106;0;0;0;0;.00nan;0;0
5121;3548;110;100;34;1;33;.971;3600000;0
5121;3663;110;0;0;0;0;.00nan;0;0
5121;3692;118;50;25;4;21;.840;3600000;0
5121;3898;118;0;0;0;0;.00nan;0;0
5123;3722;120;0;0;0;0;.00nan;0;0
5123;3801;120;77;27;2;25;.926;3600000;0
5123;3887;115;66;34;4;30;.882;3578300;0
5123;3907;115;0;0;0;0;.00nan;0;0
5125;3602;113;57;5;0;5;1.000;447900;0
5125;3635;109;100;36;1;35;.972;3600000;0
5125;3711;109;0;0;0;0;.00nan;0;0
5125;3882;113;38;30;6;24;.800;3152100;0
5127;3548;110;0;0;0;0;.00nan;0;0
5127;3663;110;78;21;1;20;.952;3600000;0
5127;3722;120;17;18;6;12;.667;1948600;0
5127;3801;120;50;13;2;11;.846;1651400;0
5129;3546;121;94;36;2;34;.944;3600000;0
5129;3751;106;0;0;0;0;.00nan;0;0
5129;3870;121;0;0;0;0;.00nan;0;0
5129;3906;106;77;34;3;31;.912;3596400;0
5131;3537;122;0;0;0;0;.00nan;0;0
5131;3558;119;0;0;0;0;.00nan;0;0
5131;3716;119;73;38;4;34;.895;3564950;0
5131;3737;122;96;37;2;35;.946;3600000;0
5133;3580;112;0;0;0;0;.00nan;0;0
5133;3712;112;93;35;2;33;.943;3600000;0
5133;3754;117;0;0;0;0;.00nan;0;0
5133;3913;117;72;36;4;32;.889;3588100;0
5135;3602;113;65;25;3;22;.880;3900000;0
5135;3633;114;89;39;3;36;.923;3900000;0
5135;3882;113;0;0;0;0;.00nan;0;0
5135;3901;114;0;0;0;0;.00nan;0;0
5137;3513;108;91;40;2;38;.950;3555400;0
5137;3596;108;0;0;0;0;.00nan;0;0
5137;3635;109;0;0;0;0;.00nan;0;0
5137;3711;109;85;25;1;24;.960;3600000;0
5139;3514;123;70;23;2;21;.913;3600000;0
5139;3676;123;0;0;0;0;.00nan;0;0
5139;3887;115;0;0;0;0;.00nan;0;0
5139;3907;115;86;45;4;41;.911;3526900;0
5141;3512;116;68;47;6;41;.872;3600000;0
5141;3530;107;85;25;1;24;.960;3600000;0
5141;3613;116;0;0;0;0;.00nan;0;0
5141;3909;107;0;0;0;0;.00nan;0;0
5143;3589;111;0;0;0;0;.00nan;0;0
5143;3692;118;0;0;0;0;.00nan;0;0
5143;3857;111;76;25;2;23;.920;3564750;0
5143;3898;118;90;28;1;27;.964;3600000;0
5145;3514;123;0;0;0;0;.00nan;0;0
5145;3676;123;91;41;3;38;.927;3600000;0
5145;3887;115;57;29;4;25;.862;3552200;0
5145;3907;115;0;0;0;0;.00nan;0;0
5147;3589;111;61;25;3;22;.880;3560600;0
5147;3602;113;0;0;0;0;.00nan;0;0
5147;3857;111;0;0;0;0;.00nan;0;0
5147;3882;113;84;30;2;28;.933;3600000;0
5149;3513;108;0;0;0;0;.00nan;0;0
5149;3580;112;90;40;3;37;.925;3600000;0
5149;3596;108;46;22;4;18;.818;3556750;0
5149;3712;112;0;0;0;0;.00nan;0;0
5151;3530;107;0;0;0;0;.00nan;0;0
5151;3635;109;63;37;5;32;.865;3600000;0
5151;3711;109;0;0;0;0;.00nan;0;0
5151;3909;107;45;34;6;28;.824;3552450;0
5153;3512;116;0;0;0;0;.00nan;0;0
5153;3537;122;87;38;3;35;.921;3600000;0
5153;3613;116;55;33;5;28;.848;3545800;0
5153;3737;122;0;0;0;0;.00nan;0;0
5155;3633;114;0;0;0;0;.00nan;0;0
5155;3722;120;0;0;0;0;.00nan;0;0
5155;3801;120;60;24;3;21;.875;3564450;0
5155;3901;114;91;32;1;31;.969;3600000;0
5157;3548;110;65;33;4;29;.879;3600000;0
5157;3663;110;0;0;0;0;.00nan;0;0
5157;3751;106;74;30;3;27;.900;3600000;0
5157;3906;106;0;0;0;0;.00nan;0;0
5159;3692;118;86;26;1;25;.962;3600000;0
5159;3754;117;90;35;2;33;.943;3588200;0
5159;3898;118;0;0;0;0;.00nan;0;0
5159;3913;117;0;0;0;0;.00nan;0;0
5161;3546;121;0;0;0;0;.00nan;0;0
5161;3558;119;60;36;5;31;.861;3600000;0
5161;3716;119;0;0;0;0;.00nan;0;0
5161;3870;121;100;32;0;32;1.000;3600000;0
5163;3558;119;0;0;0;0;.00nan;0;0
5163;3716;119;78;39;4;35;.897;3600000;0
5163;3722;120;39;30;6;24;.800;2609100;0
5163;3801;120;53;9;1;8;.889;990900;0
5165;3580;112;0;0;0;0;.00nan;0;0
5165;3712;112;100;31;1;30;.968;3600000;0
5165;3751;106;0;0;0;0;.00nan;0;0
5165;3906;106;49;24;4;20;.833;3600000;0
5167;3530;107;100;33;0;33;1.000;3600000;0
5167;3546;121;57;11;1;10;.909;1489700;0
5167;3870;121;58;35;5;30;.857;2110300;0
5167;3909;107;0;0;0;0;.00nan;0;0
5169;3602;113;64;35;4;31;.886;3900000;0
5169;3635;109;0;0;0;0;.00nan;0;0
5169;3882;113;0;0;0;0;.00nan;0;0
5169;5322;109;80;40;4;36;.900;3900000;0
5171;3513;108;52;32;5;27;.844;3533950;0
5171;3514;123;85;37;3;34;.919;3600000;0
5171;3596;108;0;0;0;0;.00nan;0;0
5171;3676;123;0;0;0;0;.00nan;0;0
5173;3548;110;89;28;1;27;.964;2489900;0
5173;3663;110;32;15;4;11;.733;1110100;0
5173;3692;118;0;0;0;0;.00nan;0;0
5173;3898;118;91;17;0;17;1.000;3600000;0
5175;3512;116;70;35;4;31;.886;3527600;0
5175;3537;122;0;0;0;0;.00nan;0;0
5175;3613;116;0;0;0;0;.00nan;0;0
5175;3737;122;79;34;3;31;.912;3600000;0
5177;3589;111;0;0;0;0;.00nan;0;0
5177;3754;117;0;0;0;0;.00nan;0;0
5177;3857;111;97;43;3;40;.930;3600000;0
5177;3913;117;41;32;6;26;.813;3600000;0
5179;3633;114;74;41;5;36;.878;3576700;0
5179;3887;115;0;0;0;0;.00nan;0;0
5179;3901;114;0;0;0;0;.00nan;0;0
5179;3907;115;94;42;3;39;.929;3600000;0
